QQ为什么还是不可以电脑和ipad同时登陆	ASK
为什么还是不可以和ip同时	ASK
微信还是电脑ipad登陆	ASK
微信为什么还是不可以计算机和ipad同时登陆	ASK
微信为什么还是不可以和ip	ASK
微信为什么还是可以电脑ipad同时	ASK
微信还是不可以电脑和ipad同时登陆	ASK
微信为什么还是不可以笔记本电脑和ipad同时登陆	ASK
微信为什么还是不可以电脑和ipad登陆	ASK
微信为什么还是不可以和ipad登陆	ASK
微信为什么还是不可以微电脑和ipad同时登陆	ASK
为什么还是不可以电脑和ipad同时登陆	ASK
微信为什么还是不可以个人电脑和ipad同时登陆	ASK
微信为什么还是不电脑和ad同时登陆	ASK
微信为什么还是不可以电脑系统和ipad同时登陆	ASK
微信为什么还是不可以电脑ipad登陆	ASK
微信为什么不可以电脑和ipad同时登陆	ASK
微信为什么不电脑ipad同时登陆	ASK
还是不可以电脑和ad同时	ASK
微信为什么还是不可以笔记型电脑和ipad同时登陆	ASK
微信为什么还是不可以电脑ad同时登陆	ASK
微信还是不电脑和ipad同时登陆	ASK
微信为什么不和ipad同时	ASK
买衬衣，买鞋，买生活用品，打车，吃饭，转账。在生活中无所不在的提供方便	GF
想买衣服，买鞋，想买生活用品，打车，吃饭，转账。在生活中无所不在的提供方便	GF
买，买鞋买生活用品，打车，吃饭转账。在生活中无处不在的提供方便	GF
是否应该添加一个写出日志提醒的闹钟或者通知提醒	ADV
是否应该添加一个写日志提醒闹钟或者通知提醒	ADV
是否应该添加一个写日志告诫的闹钟或者通知告诫	ADV
是否应该添加一个写提醒的闹钟通知提醒	ADV
是否应该一个日志提醒的或者通知	ADV
是否应该添加一个写下日志提醒的闹钟或者通知提醒	ADV
入群验证能否验证提示，像QQ群入群一样有个加群的条件提示	ADV
入群验证能否加个提示，像QQ群入群一样，有个加群条件提示	ADV
入群验证能否加个验证提示，像微信群入群验证一样，有个加群的前提提示	ADV
入群验证能否加个提示，像QQ群验证一样，加群的条件	ADV
入群验证能否加个验证提示，像APP群入群验证一样，有个加群的前提提示	ADV
入群验证加个验证提示，像QQ群验证一样，加群的条件	ADV
一个财务管理软件产品竟然占用了我一百多兆，身为小内存手机用户不得不吐槽一下了	BF
一个财务管理软件占用了我，身为小不得不吐槽一下了	BF
一个财务管理软件竟然占用了我三千多兆，身为小内存客户端不得不吐槽一下了	BF
一个占用了我兆，身为小内存用户不得不一下了	BF
一个财务管理软件产品竟然占用了我一百多兆，身为小内存消费者不得不吐槽一下了	BF
一个软件竟然占用了我一百多，身为内存用户不得不吐槽一下	BF
更新后的QQ太日龙了，QQ更新后，网易视频会员QQ账号登录不了了，很多授权的Store会员都登录不上了，老子表示百分之一百不令人满意	BR
更新后的QQ太日龙了，QQ更新后，新浪音频会员QQ账号登录不了了，很多授权的APP会员都登录不上了，老子表示百分之一百不满意	BR
更新后的微信太日龙了，微信更新后，百度视频会员微信账号登录不了了，很多许可的APP会员都登录不上了，董仲舒表示百分之一百不满意	BR
更新后微信太日龙，微信更新后，视频会员登录不了了很多的app会员都不上了，老子百分之一百不满意	BR
更新后微信了，微信更新，腾讯视频会员微信账号不了了，很多授权的app都不上了老子表示不满意	BR
后的太日龙了，更新后，视频会员微信账号登录不了了，很多授权的app会员都登录不上了表示百分之一百不满意	BR
更新后的微信了，微信更新后，腾讯视频会员微信账号了，很多授权的app都不上了，老子表示百分之一百不满意	BR
更新后的微信太日龙了，微信更新后，腾讯视频会员微信账号登录不了了，很多许可的APP会员都登录不上了，周易表示百分之一百不令人满意	BR
更新后的微信太日龙了，微信后，腾讯视频会员微信登录了，很多授权的app会员都登录不上，老子百分之一百不满意	BR
更新后的QQ太日龙了，QQ更新后，腾讯片段会员QQ邮箱登录不了了，很多许可的app会员都登录不上了，老子表示百分之一百不满意	BR
更新后的微信太日龙了微信更新，腾讯视频会员微信登录了，很多授权的app会员都登录不上了，老子百分之一百不	BR
腾讯视频现在真是飘，都不这样了，都VIP了看个电影，电视剧还得额外花钱。都没人用就好了	BF
腾讯视频现在飘了，都卸载就不了，都VIP了，，电视剧还得。都就了	BF
京东截图现在真是飘了，都卸载就不这样了，都VIP了，看个电影，电视剧还得额外掏钱。都没人用就好了	BF
腾讯截图现在真是飘了，都卸载就不这样了，都VIP了，看个电视剧，电视剧还得额外掏钱。都没人用就好了	BF
垃圾广告那么就想让冲会员，偏不充	BF
废弃物，广告那么多就想让冲会员，偏不充	BF
，广告那么就想让冲，偏不充	BF
，广告那么多就想让冲，偏不充	BF
垃圾，商业广告那么多就想让冲会员，偏不充	BF
Y10感谢阿里巴巴音频，陪伴我的每一天，希望你们永远优秀下去	GF
Y10感谢腾讯录像，陪伴我的每一天，希望你们永远杰出下去	GF
Y10感谢腾讯视频，陪伴的每一天，希望你们永远优秀	GF
Y10感谢视频陪伴我的每一天，希望你们优秀下去	GF
Y10感谢百度视频，陪伴我的每一天，希望你们永远杰出下去	GF
感谢腾讯视频，陪伴我一天，希望你们永远优秀下去	GF
文字信息发不出去，图片秒发的节奏感	BR
信息发不出去，秒发的	BR
文字信息不出去图片秒发的节奏	BR
信息发不，秒	BR
文字信息发不出去，截图秒发的节奏	BR
文字信息发不出去，照片秒发的节奏	BR
文字信息发不出去，图片秒发的鼓点	BR
美剧全，画质清晰，方便好用	GF
H6，画质清晰，方便	GF
哈弗美剧全，画质清晰，方便好用	GF
一直崩一直无法歌单一直闪退	BR
一直播放一直闪退	BR
一直崩一直无法播映歌单一直闪退	BR
一直崩播放歌单一直闪退	BR
一直崩一直无法重播歌单一直闪退	BR
一直崩无法播放歌单闪退	BR
一直崩一直无法播送歌单一直闪退	BR
一直崩一直无法首播歌单一直闪退	BR
一直崩一直无法放映歌单一直闪退	BR
如题，没有去除缓存的选项看着还是有些不舒服哒，期望工程师大大加入进去	ADV
，没有缓存的选项看着有些不舒服哒，希望工程师大大加入	ADV
如题，没有清除缓存的选项还是有些不哒，工程师大大	ADV
如题，没有清除缓存的选项看着还是有些不舒服哒，期望项目经理大大加入进去	ADV
如题，没有清除缓存的选项看着还是有些不难受哒，期望工程师大大加入进去	ADV
如题目，没有清除寄存器的选项看着还是有些不舒服哒，希望工程师大大加入进去	ADV
如题，没有清除磁盘的选项对着还是有些不舒服哒，希望工程师大大加入进去	ADV
题，没有清除缓存的选项还是有些哒，希望工程师大大加入进去	ADV
很讨厌，每一次更新都在进步，一如既往的支持	GF
很喜欢，更新都在进步的支持	GF
很喜爱，每一次更新都在进步，一如既往的支持	GF
喜欢，每一次更新在一如既往支持	GF
很喜欢，每一次更新都在一如既往的	GF
很好，很不俗的播放器，个人感觉比PPS等强很多，我们提的建议也能及时改良，但是有一点我不明白，为什么新手机QQ就做得如此失败呢	ASK
，很不错的播放器，个人感觉比PPS很多，我们提的也能及时改进，但是我不明白为啥手机就做得如此呢	ASK
很好，很不错比PPS等很多我们提的建议也能及时，但是我明白，为啥手机QQ做得如此	ASK
很好，很上佳的播放机，个人感觉比PPS等强很多，我们提的建议也能及时改进，但是有一点我不明白，咋手机微信就做得如此失败呢	ASK
极好，很不错的播放器，个人感觉比PPS等强很多，我们提的建议也能及时改进，但是有一点我不知道，为什么智能手机QQ就做得如此失败呢	ASK
很好，很不错的播放器个人感觉比PPS等强，我们提建议能及时改进，但是我不明白，为啥手机QQ就做如此呢	ASK
更好，很不俗的播放机，个人感觉比PPS等强很多，我们提的建议也能及时进一步改进，但是有一点我不明白，为啥手机QQ就做得如此失败呢	ASK
很好，很不俗的播放器，个人感觉比PPS等强很多，我们提的建议也能及时改进，但是有一点我不知道，为什么手机APP就做得如此失败呢	ASK
很好很的播放器，个人感觉比等强很多，我们提的建议也能及时改进，但是有一点我明白为啥手机QQ做得如此失败呢	ASK
很好，很上佳的音箱，个人感觉比PPS等强很多，我们提的建议也能及时改进，但是有一点我不知道，为啥手机APP就做得如此失败呢	ASK
，很的播放器，个人感觉比PPS等强，我们提建议也能改进，但是有一点我不明白，为啥QQ做得如此呢	ASK
很好，很不错的播放器，个人感觉比PPS等强很多，我们提的建议也能及时进一步改进，但是有一点我不明白，为啥智能手机微信就做得如此失利呢	ASK
很好，很不错的播放器，个人感觉比等强很多，提的建议也能及时改进，但是有一点我明白，为啥手机就得如此失败	ASK
更好，很不错的音箱，个人感觉比PPS等强很多，我们提的建议也能及时改进，但是有一点我不明白，为啥智能手机QQ就做得如此失利呢	ASK
很好，很不错的播放器，个人感觉比PPS等强，我们提的建议也能改进，有一点我不明白，为啥手机QQ就做得失败呢	ASK
很好很不错的播放器，个人感觉比PPS等强很多我们的建议也能及时改进，但是有一点不，为啥手机就做得如此失败呢	ASK
很好，很很棒的播放器，个人感觉比PPS等强很多，我们提的建议也能及时改进，但是有一点我不知道，为啥笔记本电脑QQ就做得如此失利呢	ASK
很好，很不错的MP3，个人感觉比PPS等强很多，我们提的建议也能及时改进，但是有一点我不知道，为啥手机APP就做得如此失利呢	ASK
，很不错的播放器个人感觉PPS等强很多，我们的建议也能及时但是不明白手机QQ就得如此呢	ASK
很好，很不错的播放器个人感觉比PPS很多，我们提的也能及时，我不，为啥手机就做得如此失败呢	ASK
很好，很不错的播放器，个人感觉比PPS等强很多，我们提的建议也能及时进一步改进，但是有一点我不明白，为啥笔记本微信就做得如此失利呢	ASK
很好很不错的播放器，个人感觉比PPS等强很多，的建议也能及时改进，我不明白，手机QQ就做得如此失败呢	ASK
更好，很不错的播放机，个人感觉比PPS等强很多，我们提的建议也能及时改进，但是有一点我不知道，为啥电脑QQ就做得如此失败呢	ASK
极好，很不俗的播放器，个人感觉比PPS等强很多，我们提的建议也能及时改进，但是有一点我不明白，为啥手机APP就做得如此失利呢	ASK
很好，很不错的播放器个人感觉比PPS等强很多我们提的建议能及时改进，但是有一点我不明白，为啥手机QQ就做得如此失败呢	ASK
，很不错的播放器，个人感觉比PPS强很多，我们提的也能及时改进，但是有一点我不明白，为啥手机QQ就做得如此失败	ASK
更好，很不错的播放器，个人感觉比PPS等强很多，我们提的建议也能及时改良，但是有一点我不明白，为什么手机QQ就做得如此失利呢	ASK
很好，很不错的播放器，比PPS强很多，我们提的建议也能及时改进，但是有一点我不明白，为啥手机QQ就做得如此失败呢	ASK
很好，很不俗的播放器，个人感觉比PPS等强很多，我们提的建议也能及时改进，但是有一点我不明白，为什么iPhone4QQ就做得如此失利呢	ASK
，很的播放器，强很多提的建议也能，有一点不手机QQ就得如此失败呢	ASK
很好，很不错的播放器，个人感觉PPS等强很多，我们提的建议也能改进，但是有一点我不，为啥手机QQ做得如此失败呢	ASK
很好，很上佳的播放器，个人感觉比PPS等强很多，我们提的建议也能及时改良，但是有一点我不明白，为啥笔记本电脑QQ就做得如此失利呢	ASK
更好，很极好的播放器，个人感觉比PPS等强很多，我们提的建议也能及时改良，但是有一点我不明白，咋手机QQ就做得如此失败呢	ASK
更好，很极好的播放器，个人感觉比PPS等强很多，我们提的建议也能及时进一步改进，但是有一点我不知道，为啥手机QQ就做得如此失败呢	ASK
较好，很不错的随身听，个人感觉比PPS等强很多，我们提的建议也能及时进一步改进，但是有一点我不知道，为啥手机QQ就做得如此失败呢	ASK
很好不错的个人感觉比PPS等很多，我们提的建议也能及时改进，不明白手机QQ得如此失败呢	ASK
很好，不错的个人感觉比PPS等很多，的也改进但是有一点我不明白，为啥QQ就做得如此呢	ASK
很好，很不错的播放器，个人感觉比PPS等强很多，我们提的建议也能及时进一步改进，但是有一点我不知道，为啥iPhone4APP就做得如此失败呢	ASK
用着挺不错，会员小贵	ADV
朋友圈明明设置的三天可见，可别人偏偏看不见三天可见这几个字，直接变成一条横线，就跟过滤了别人一样。什么污水bug啊，他们都来质问，烦死了	BR
朋友圈明明设置的三天可见，可别人偏偏看不见三天可见这几个字，直接变成两条横线，就跟过滤了别人一样。什么垃圾BUG啊，他们都来问，烦死了	BR
朋友圈明明设立的两天可见，可别人偏偏看不见两天可见这几个字，直接变成一条横线，就跟屏蔽了别人一样。什么垃圾BUG啊，他们都来问，烦死了	BR
设置的三天可见别人偏偏看不见三天可见这几个字，直接变成横线，就跟别人一样。垃圾bug啊，所有人都来问，烦死了	BR
朋友圈明明设置的三天，可别人偏偏看不见三天可见几个字变成一条横线，就跟屏蔽了别人一样。什么垃圾bug啊，所有人都来问，烦死了	BR
朋友圈明明设置的三天可见，可别人偏偏看不见三天可见这几个字，直接变成两条横线，就跟屏蔽了别人一样。什么垃圾Bug啊，他们都来反问，烦死了	BR
明明设置的可见，可别人看不见三天这，直接一条横线，就屏蔽了别人一样。垃圾bug啊所有人都来问烦死	BR
朋友圈明明设置的六天可见，可别人偏偏看不见六天可见这几个字，直接变成两条横线，就跟屏蔽了别人一样。什么废弃物bug啊，所有人都来问道，烦死了	BR
只要无隐患，会一直用下去	GF
只要无安全隐患，一直用	GF
无安全隐患，会一直用下去	GF
最初以为是类似豆瓣电台个人网络电台类应用，用了几天才发现可以代替很多在线音乐类软件了曲库十分丰富，分享功能也很好，整个感觉都不错，很惊喜	GF
最初以为是类似豆瓣电台的个人网络电台类应用，用了发现可以代替很多在线音乐类软件，十分丰富分享功能，整个感觉都不错，很惊喜	GF
最初以为是类似豆瓣广播的个人网络电台类应用，用了几日才发现可以代替很多在线音乐类软件了，曲库十分丰富，分享功能也极好，整个感觉都极好，很惊喜	GF
最初以为是类似豆瓣电台类应用，用了几天才发现可以代替很多在线音乐类软件了，十分丰富功能也很好，整个感觉不错，很惊喜	GF
传送消息会粘在通告面板上，删也删不掉，以往的消息总是留在面板上天天能看见好烦，就可以重启手机。天天重启，以为升级新版本QQ就好了，然而还是一个品行，强迫症看着真郁闷	BR
粘在通知面板上删也删不掉以往的消息总是留在面板上天天能看见，只能重启。天天重启，以为升级新版本微信就好了然而一个德行，强迫症看着郁闷	BR
会粘在通知面板上，也删不掉，以往的消息总是留在面板上天天能看见好烦，只能重启手机。天天重启，升级微信就好了然而还是，强迫症真郁闷	BR
传送最新消息会粘在通知面板上，删也删不掉，以往的最新消息总是留在面板上天天能看见好烦，只能重启手机。天天重启，以为升级新版本微信就好了，然而还是一个德行，强迫症对着真的懊恼	BR
推送消息会粘在通告液晶面板上，删也删不掉，以往的消息总是留在液晶面板上天天能看见好烦，只能重新启动iPhone4。天天重新启动，以为升级新版本微信就好了，然而还是一个德行，抑郁看着真郁闷	BR
推送消息会粘在面板上删也删不掉以往的消息总是留在面板上天天能看见，只能重启天天，升级新版本微信好了，还是一个德行真郁闷	BR
传送最新消息会黏在通知面板上，删也删不掉，以往的最新消息总是留在面板上天天能看见好烦，只能重启新手机。天天重启，以为升级新版本微信就好了，然而还是一个德行，精神分裂症看着真郁闷	BR
免费还很好用。功能很多	GF
免费用。功能很多	GF
免费的还较好用。功能很多	GF
免费的还很好用。机能很多	GF
较好用，也方便，只是自从邻居手机拿走了，用我手机登录一次他的钉钉帐号后，我发给他的消息打给他的邮件都转我手机上了，怎样可以彻底注销他的登录啊	ASK
很好用，也方便，只是自从邻居智能手机丢了，用我智能手机登录一次他的钉钉邮箱后，我发给他的最新消息打给他的手机短信都转我智能手机上了，怎样可以彻底注销他的登录啊	ASK
很好用，，只是自从手机丢了，用我手机登录一次他的账号后，我发给他的消息他的短信都转我手机上了怎样彻底注销他的啊	ASK
用，也方便只是自从手机了，我手机登录一次钉钉账号后，我发给他的消息打给他的短信都转我手机上了，怎样彻底注销他的登录	ASK
较好用，也方便，只是自从同僚电脑丢了，用我电脑登录一次他的钉钉账号后，我发给他的最新消息打给他的电话都转我电脑上了，怎样可以彻底注销他的登录啊	ASK
很好，也方便，只是自从同事手机丢了，手机登录一次他的账号后，我发给他的消息打给他短信都转我手机了，怎样可以彻底注销他登录啊	ASK
很好用，也方便，只是同事手机丢了，我手机登录一次他的账号后，我发给他的打给他的短信转我上，怎样可以啊	ASK
极好用，也方便，只是自从同事手机拿走了，用我手机登录一次他的钉钉帐号后，我发给他的最新消息打给他的手机短信都转我手机上了，怎样可以彻底注销他的登录啊	ASK
较好用，也方便，只是自从同僚智能手机拿走了，用我智能手机登录一次他的钉钉手机号后，我发给他的消息打给他的短信都转我智能手机上了，怎样可以彻底注销他的登录啊	ASK
更好用，也方便，只是自从同事iPhone4偷了，用我iPhone4登录一次他的钉钉账号后，我发给他的最新消息打给他的邮件都转我iPhone4上了，怎样可以彻底注销他的登录啊	ASK
很好用，，只是自从同事手机丢了，用我手机登录的钉钉，发给他的消息打给他短信转我手机上了怎样可以注销他的登录	ASK
极好用，也方便，只是自从同事新手机偷了，用我新手机登录一次他的钉钉账号后，我发给他的最新消息打给他的电子邮件都转我新手机上了，怎样可以彻底注销他的登录啊	ASK
很好用，也方便，只是自从同事手机了，用手机一次他的钉钉后，我发给他的消息打给他短信都转手机上了，可以彻底注销的登录啊	ASK
极好用，也方便，只是自从同事新手机偷了，用我新手机登录一次他的钉钉手机号后，我发给他的消息打给他的手机短信都转我新手机上了，怎样可以彻底注销他的登录啊	ASK
很好用，方便，自从同事丢了，用我手机一次他的钉钉账号后，发给他的打给他短信我手机上，怎样可以彻底注销他的	ASK
更好用，也方便，只是自从同事iPhone4丢了，用我iPhone4登录一次他的钉钉手机号后，我发给他的最新消息打给他的简讯都转我iPhone4上了，怎样可以彻底注销他的登录啊	ASK
用，方便，只是自从同事手机丢了，用我手机登录一次他的钉钉后，发给的消息打给他的短信转我手机上了，怎样彻底注销他的登录	ASK
较好用，也方便，只是自从同僚笔记本电脑偷了，用我笔记本电脑登录一次他的钉钉帐号后，我发给他的消息打给他的短信都转我笔记本电脑上了，怎样可以彻底注销他的登录啊	ASK
很好，也方便，只是同事手机丢了我手机登录一次的钉钉后我发给他他都转我手机上了，怎样彻底注销他的登录啊	ASK
极好用，也方便，只是自从同学笔记本电脑丢了，用我笔记本电脑登录一次他的钉钉账号后，我发给他的最新消息打给他的发短信都转我笔记本电脑上了，怎样可以彻底注销他的登录啊	ASK
很好用，也方便，只是同事手机丢，用我登录一次钉钉账号后，我发给他的消息打给他短信都转我手机，怎样可以彻底注销他的登录啊	ASK
较好用，也方便，只是自从邻居手机拿走了，用我手机登录一次他的钉钉手机号后，我发给他的最新消息打给他的短信都转我手机上了，怎样可以彻底注销他的登录啊	ASK
很好用，方便自从同事手机了，用我手机登录一次他的钉钉账号我发给他的消息打给他的短信都转我手机上了，可以彻底注销他的登录啊	ASK
用，也方便，只是自从丢用我手机登录他钉钉账号后，发给他的消息打给他的短信转手机上了，可以注销他登录啊	ASK
极好用，也方便，只是自从同学手机拿走了，用我手机登录一次他的钉钉账号后，我发给他的最新消息打给他的电子邮件都转我手机上了，怎样可以彻底注销他的登录啊	ASK
很好用，方便，只是自从同事手机丢了，我手机登录一次的钉钉账号后，我发给他的消息他短信转我上了，怎样可以彻底注销他的登录啊	ASK
较好用，也方便，只是自从同事新手机拿走了，用我新手机登录一次他的钉钉手机号后，我发给他的最新消息打给他的短信都转我新手机上了，怎样可以彻底注销他的登录啊	ASK
极好用，也方便，只是自从同僚iPhone4偷了，用我iPhone4登录一次他的钉钉账号后，我发给他的消息打给他的电邮都转我iPhone4上了，怎样可以彻底注销他的登录啊	ASK
很好用，也方便，只是自从同事手机丢了，我手机登录一次他的钉钉账号后，我消息打给的短信都转我手机上了，怎样彻底注销他的登录啊	ASK
很好用，也方便，只是自从邻居iPhone4偷了，用我iPhone4登录一次他的钉钉邮箱后，我发给他的消息打给他的电话都转我iPhone4上了，怎样可以彻底注销他的登录啊	ASK
很好用，也方便，只是自从同事手机丢了，我登录一次他的钉钉账号后，我发给他的消息打给他短信转我手机上，怎样可以彻底注销他登录啊	ASK
很好用，也方便，只是自从同事手机丢了，用我手机他的钉钉账号，发给他消息打给他的短信都我手机了，可以彻底注销他的登录啊	ASK
较好用，也方便，只是自从同事笔记本拿走了，用我笔记本登录一次他的钉钉账号后，我发给他的最新消息打给他的手机短信都转我笔记本上了，怎样可以彻底注销他的登录啊	ASK
很好用，方便，只是自从同事手机丢，我手机一次的钉钉账号后，发给的消息打给他的转我手机上了，怎样可以彻底注销他登录啊	ASK
很好用，也方便，只是自从同事手机丢，我一次他的钉钉账号后，我发给他的消息打给的短信都转我手机上了，怎样可以彻底注销他的啊	ASK
极好用，也方便，只是自从同学手机拿走了，用我手机登录一次他的钉钉邮箱后，我发给他的消息打给他的电话都转我手机上了，怎样可以彻底注销他的登录啊	ASK
极好用，也方便，只是自从同僚智能手机偷了，用我智能手机登录一次他的钉钉账号后，我发给他的最新消息打给他的短信都转我智能手机上了，怎样可以彻底注销他的登录啊	ASK
最好的听歌软件却是最走心听歌软件	GF
不是最好的听歌软件，看似最走心的听歌软件	GF
不是最好的听歌开发工具，却是最走心的听歌开发工具	GF
不是最好的听歌软件，却是最的听歌	GF
用过这个之后再也不想用别的，的音乐相当对胃口	GF
用过这个之后再也不想用别的了，推荐的对胃口	GF
用过这个之后再也不肯用别的了，推荐的音乐相当对胃口	GF
用过之后再也不想用，的音乐	GF
手表应用无法打卡，	BF
完全更新不了卸载也重装你我玩儿	BR
完全更新卸载也重装不了你都我啦	BR
完全更新不了卸载也不了我玩儿	BR
完全更新不了卸载也不了你都我啦	BR
真的很不错，很多好听音乐	GF
真的很不错很多好听音乐	GF
就算很不错，很多好听的音乐	GF
呢很不错，很多好听的音乐	GF
知道账号密码登录却显示在崭新设备上登录要验证短信，我的卡早丢掷了致使以前的号登录不上去，里面的东西对我很重要，打客服也没用，我知道账号密码都难以证明我是该邮箱的女主人嘛？醉了，卸载了。有邮箱有私钥却登录不了，服气	BR
知道账号密码登录却显示在新设备要验证短信我的卡早了导致以前的号登录上去，里面的东西对我重要打也我账号密码不足以证明我是该账号的嘛，卸载了。有有密码却不了，服气	BR
账号密码登录显示在新上登录要短信，我的卡早扔了导致以前登录上去里面的东西对我很重要，打客服也没用，我知道账号密码证明我是该账号的嘛？了，卸载了。有有密码却登录，服气	BR
知道账号密码登录却在新设备要验证短信，我扔了导致以前号登录不上去，的东西对很，打客服也没用，我账号密码都不足以证明我该账号的主人嘛？醉了，。账号有密码登录不了，服气	BR
知道账号密码登录却表明在新设备上登录要验证简讯，我的卡早扔了引致以前的号登录不上去，里面的东西对我很重要，打客服也不行，我知道账号密码都无法证明我是该账号的仆人嘛？醉了，卸载了。有账号有密钥却登录不了，服气	BR
知道账号密码登录在新设备上登录要验证短信，的卡早扔了以前的号登录不上去的对我很重要，打客服也都不足以证明我是该账号的主人嘛？醉了，卸载了。有有密码却不了服气	BR
知道账号密码登录却显示在崭新电源上登录要验证发短信，我的卡早扔了导致以前的号登录不上去，里面的东西对我很重要，打客服人员也没用，我知道账号密码都无法证明我是该账号的女主人嘛？醉了，卸载了。有账号有密钥却登录不了，服气	BR
知道账号密码登录却表明在新设备上登录要验证简讯，我的卡早扔了导致以前的号登录不上去，里面的东西对我很重要，打客服人员也不行，我知道账号密码都不足以证明我是该帐号的仆人嘛？醉了，卸载了。有帐号有私钥却登录不了，服气	BR
登录却显示在新要验证短信，我的卡早扔了以前的登录不上去，的东西对我很重要打客服也没用，我知道不足以我是账号的嘛？醉了，卸载了。账号有密码却登录不了，服气	BR
我们更新点用的，浪费流量要更新更新点有用，是手机用户	BF
我们更新点么用的东西浪费流量，要更新就点有用的，是手机用户	BF
卡卡卡卡病死了。投屏也特的么投不上。爱奇艺除非网不好的时候会卡，但是腾讯也许是无缘无故卡	BR
卡卡。投屏特投不上。爱除非网的时候会卡，但是腾讯真的是卡	BR
卡卡卡卡死了。投屏也特么投不上。爱奇艺除非网太差的时候会卡，但是百度吗是无缘无故卡	BR
卡卡卡卡死了。投屏也特和么投不上。爱奇艺除非网太差的时候会卡，但是腾讯难道是无缘无故卡	BR
卡卡卡卡死投屏特么投不上。爱奇艺网不好的时候，但是腾讯真的是无缘无故卡	BR
死了。也特么。除非网不好的时候，但是腾讯无缘无故卡	BR
卡卡卡卡过世了。投屏也特么投不上。爱奇艺除非网不太好的时候会卡，但是搜狗真的是无缘无故卡	BR
卡卡卡卡死去了。投屏也特么投不上。爱奇艺除非网不好的时候会卡，但是阿里巴巴就算是无缘无故卡	BR
最喜欢的音乐开发工具干净温馨	GF
最喜欢的音乐软件整洁温馨	GF
最喜欢的软件干净温馨	GF
更新之前指纹缴付好用，更新至8。5后指纹缴付失灵，再也无法录入指纹	BR
更新之前指纹支付，更新至8。5指纹支付失效，再也无法录入指纹	BR
更新之前指纹好用，至8。5后支付失效，再也无法录入指纹	BR
更新之前指纹支付好用，更新至8。5支付失效，再也无法录入	BR
车载蓝牙连接上之后，每句词句和歌曲图一起跳动，手机也是换第一句词句屏幕亮一下，希望修复此bug	BR
车载蓝牙上之后，每句歌词和专辑一起跳动手机是换一句歌词屏幕亮一下，希望修复此bug	BR
车载连接上之后，每句歌词和一起跳动，也换一句歌词，修复	BR
车载连接之后，每句和专辑图一起也是换歌词屏幕亮一下，希望修复此bug	BR
车载蓝牙连接上之后，每句歌名和专辑图一起跳动，智能手机也是换一句歌名屏幕亮一下，希望重建此bug	BR
车载耳机连接上之后，每句歌词和专辑图一起跳动，电脑也是换一句歌词屏幕亮一下，希望修复此BUG	BR
车载蓝牙连接上之后，每句歌词和专辑一起跳动，手机也是换一句歌词屏幕亮一下，希望此bug	BR
连接，和专辑图一起，也是换一句歌词亮，希望修复bug	BR
车载耳机连接上之后，每句歌词和张唱片图一起跳动，手机也是换一句歌词屏幕亮一下，希望修复此BUG	BR
车载蓝牙上之后，每句和专辑图一起跳动，手机换一句歌词屏幕一下，希望修复此bug	BR
交接用手机？就屏幕大是吗？为什么电脑填	BF
交接事项手机就你屏幕大是吗？为什么版不能填	BF
交接事项用电脑？就你触摸屏大是吗？为什么电脑版不能填	BF
交接事项用智能手机？就你显示器大是吗？为什么电脑版不能填	BF
交接事项用手机？就你界面大是吗？为什么电脑系统版不能填	BF
为什么下载完的微信没有到手机	ASK
为什么完的没有到手机	ASK
为什么下载完的微信没有到iPhone4桌面上	ASK
为什么下载完的微信没有到手机上面	ASK
为什么下载完的QQ没有到手机桌面上	ASK
为什么下载完的微信没有到桌面上	ASK
为什么下载的没有到手机桌面上	ASK
为什么上传完的微信没有到手机桌面上	ASK
为什么下载完的微信没有到手机桌上	ASK
为什么下载完的微信没有手机	ASK
为什么下载完的微信没有手机桌面上	ASK
为什么完微信到手机桌面上	ASK
为什么下载的微信没有到手机	ASK
为什么iTunes完的微信没有到手机桌面上	ASK
为什么下载微信没有到手机桌面上	ASK
的到手机桌面上	ASK
为什么完的微信没有到手机桌面上	ASK
为什么下载完的微信没有到笔记本桌面上	ASK
为什么浏览完的微信没有到手机桌面上	ASK
腾讯给我们带来很多精彩的生活美满。我也很喜欢腾讯的服务。我祝你们以后更为更好，更为发展战略	GF
腾讯给我们带来很多精彩的生活美满。我也很钟爱腾讯的服务。我祝你们以后更更好，更发展	GF
腾讯给我们带来很多精彩的生活美满。我也很钟爱腾讯的服务。我祝你们以后越来越更快，越来越发展	GF
腾讯给我们带来很多的生活美满。我也喜欢腾讯服务。我祝你们以后越来越更好越来越发展	GF
给我们很多精彩的生活美满。我也很腾讯的服务。我祝你们以后越来越更好越来越	GF
6s3d_iPod快捷功能里面其他功能正常，只有候车码这一项有问题，具体是选择之后只表明支付宝主页面，不会跳转到候车码那里	BR
6s3d_touch快捷功能其他，只有乘车码这一项有问题，选择之后只显示支付宝主页面不会跳转乘车码那里	BR
_touch功能里面功能正常，只有这一项有问题，具体是之后显示支付宝主页面，不会跳转到乘车码那里	BR
6s3d_touch快捷功能里面其他正常，只有乘车这一项有，具体是选择只显示支付宝主页面，不会跳转到乘车码	BR
6s3d_touch方便快捷机能里面其他机能正常，只有乘车码这一项有问题，具体是选择之后只显示支付宝主页面，不会重定向到乘车码那里	BR
6s3d_iPod快捷功能里面其他功能正常，只有候车码这一项有问题，具体是选择之后只显示网银主页面，不会跳转到候车码那里	BR
6s3dtouch快捷功能里面其他功能正常，只有乘车码这一项有问题，是选择之后只显示主，不会跳转到乘车码	BR
6s3d_快捷功能里面其他功能正常，只有乘车这一项有问题，具体是选择之后只显示支付宝主页面，跳转到乘车那里	BR
6s3d_快捷里面其他功能，只有乘车码一项有问题，具体是选择之后只显示支付宝主页面，不会到乘车码	BR
6s3d_iPod方便快捷功能里面其他功能正常，只有购票码这一项有问题，具体是选择之后只显示支付宝主页面，不会跳转到购票码那里	BR
6s3d_touch快捷特性里面其他特性正常，只有候车码这一项有问题，具体是选择之后只显示支付宝主网址，不会跳转到候车码那里	BR
图标都变了，打开主页也很怪异。就像缩小了主页	BR
图标都变了，开启页面也很奇特。就像缩小了页面	BR
图标都变了，打开页面也很奇怪。就缩小了页面	BR
都变了，打开页面也奇怪。就缩小了页面	BR
图标都了，页面也很奇怪。就像缩小了页面	BR
图标都变了，开启配置文件也很奇怪。就像缩小了配置文件	BR
开始菜单都变了，打开配置文件也很奇怪。就像缩小了配置文件	BR
图标都变了，页面也奇怪。就缩小页面	BR
都变，打开页面也奇怪。就像缩小页面	BR
没更新，取消了app_store的自动更新，结果早上起来防不胜防啊。我自动更新了说是，丑，新版微博或者新版QQ一样，老年人既视感，颜色也丑	BF
特地没了app_store的自动更新结果早上起来。给我自动更新说，贼丑，跟新版微博或者新版QQ一样，老年人既视感颜色也丑	BF
特地没更新，取消了APP_Store的自动更新，结果凌晨起来防不胜防啊。给我自动更新了说是，真的贼丑，搞得跟新版微博或者新版APP一样，老年人既视感，颜色也丑	BF
特地没更新，取消了app_Store的自动更新，结果清早起来防不胜防啊。给我自动更新了说是，真的斩丑，搞得跟新版博客或者新版QQ一样，老年人既视感，颜色也丑	BF
特地没更新，app的，结果早上起来防不胜防啊我说是，贼，新版微博或者新版一样，老年人既视感，颜色也丑	BF
微信尤其好玩，里面有小程序等	GF
微信特别有趣，里面有小程序等	GF
微信特别，里面有小程序等	GF
微信特别好玩，里面小程序等	GF
微信watch希望能够支持码	ADV
微信watch应用希望能够支持购票码	ADV
微信watch应用能够码	ADV
微信watch应用期望能够支持乘车码	ADV
微信watch应用希望能够支持出行码	ADV
QQwatch应用希望能够支持乘车码	ADV
watch应用希望能够支持乘车码	ADV
口区，恶心，从此再也不见，污水网易，夷平我青春，公正公正只是靠嘴说？刷票不清了解一下？装死	BF
口区，恶心，从此再也不见，，毁我青春公平只是靠嘴说？不清了解一下？装死	BF
口区，恶心，从此再也不见，垃圾网易，青春，公平公正只是说？刷票不清一下？装死	BF
口区，恶心，从此再也不见，废物百度，夷平我青春，公平公正只是靠嘴说？刷票不清了解一下？装死	BF
口区，从此再也不见，垃圾，毁青春，只是靠嘴说？刷票不清一下？	BF
退我会员费，早点吧，不花钱买版权就不要玩，好好就是了	BF
退我会员费，早点下架，不舍得花钱买版权就不要玩了，好好养猪就是了	BF
退我会员费，早点下架吧，不舍得花钱买改编权就不要玩了，好好养鸡就是了	BF
退我会员费，早点下架吧，不花钱买版权就不要玩了，好好养猪就是了	BF
用，减少了	GF
很好用，不断增加了许多麻烦	GF
很好用，降低了许多麻烦	GF
用，麻烦	GF
日韩动漫只有2部，不是	BF
日韩ACG只有2部，不是吧	BF
已经很不错了，希望能增加更多无损音乐，另外安卓版希望可以增加类似于ios的高清液晶电视版	ADV
已经不错了能增加更多无损音乐，另外安卓版希望可以增加类似于ios的高清大屏版本	ADV
已经很不错了，希望能增加更多无损音乐，另外安卓版希望可以增加类似于ios的高清液晶电视标准版	ADV
已经不错了，希望能增加更多无损，另外安卓版希望可以增加类似于ios的高清大屏版本	ADV
已经很了，希望能增加更多无损音乐，另外版希望可以增加高清大屏	ADV
已经很不错了，期望能增加更多无损音乐，另外安卓版期望可以增加类似于ios的高清液晶电视版本	ADV
已经很很棒了，希望能增加更多无损音乐，另外安卓国际版希望可以增加类似于ios的高清大屏版本	ADV
已经很不错了，希望增加更无损音乐安卓希望可以增加类似于的高清	ADV
很不错了能增加更音乐，另外安卓版希望增加ios的大屏	ADV
很不错了，能增加更多无损音乐另外安卓希望可以增加类似于ios高清大屏版本	ADV
已经很不错了，希望能增加更多无损音乐，另外iOS版希望可以增加类似于ios的高画质大屏版本	ADV
不知道怎么回事，我刚买到的智能手机怎么下载不了支付宝和58同城的APP	BR
不知道怎么回事，我刚想买的智能手机怎么下载不了支付宝和58同城的APP	BR
不知道我刚买手机怎么下载不了和58同城的APP	BR
不知道怎么回事，我刚买来的手机怎么浏览不了支付宝和58同城的APP	BR
不知道怎么回事我刚手机怎么下载不了支付宝和58同城的APP	BR
不知道怎么回事，我刚买的手机怎么不了支付宝和58同城的APP	BR
不知道怎么回事，我刚买的手机怎么下载不了支付宝和的APP	BR
不知道怎么回事，我刚卖的手机怎么订阅不了支付宝和58同城的APP	BR
把资产余额，明细放在三级菜单？请尊重每一名支付宝用户对自己资产及明细账单的查阅习惯和重视。不要不想用如此拙劣的手法弱化数字金钱观念	ADV
把金融资产余额，明细放在三级菜单？请认同每一位支付宝移动用户对自己金融资产及明细账单的查阅习惯和重视。不要想用如此拙劣的手法淡化数字金钱观念	ADV
把资产余额，明细放在三级菜单尊重每一位用户对自己资产及明细账单的查看习惯和重视。不要用如此拙劣的手法淡化数字金钱观念	ADV
把资产余额明细三级？请尊重每一位支付宝用户资产及明细账单的查看习惯和重视。不要用如此的手法淡化数字金钱观念	ADV
把余额明细放在菜单？请每一位支付宝用户对自己资产及明细账单的习惯和。不要想用如此的手法淡化金钱观念	ADV
把股权余额，明细放在三级菜单？请尊重每一位网银用户对自己股权及明细账单的查看习惯和重视。不要不想用如此拙劣的手法淡化数字金钱道德观	ADV
把金融资产余额，明细放在四级菜单？请尊重每一位支付宝用户对自己金融资产及明细账单的查看生活习惯和重视。不要想用如此拙劣的表现手法淡化数字金钱观念	ADV
把资产余额，明细放在三级菜单？请尊重支付宝用户对自己资产及单的查看习惯和。不要想用如此拙劣的手法数字金钱观念	ADV
叼你，出个这么白痴软件	BF
叼你老母，出个这么白痴的软件产品	BF
叼你老母出个这么的软件	BF
叼你老母，出个这么疯子的软件	BF
就是有时候离线的剧会卡顿	BR
就是有时候已经编辑器好的剧会卡顿	BR
就是已经好剧会卡顿	BR
就是有时候已经离线的剧会卡顿	BR
就是有时候已经app好的剧会卡顿	BR
就是有时候离线好的剧会卡顿	BR
就是有时候已经离线好的剧会	BR
就是有时候离线好剧会	BR
闲的没事开发远程监视的鬼app	BF
闲的没事开发这种远程侦察的鬼app	BF
闲的没事开发这种远程监视的app	BF
闲的没事开发这种远程监视的鬼APP	BF
无语了，更新不了，一直显示此时无法加装，搞得QQ打也打不开，想著删了重新下一个，结果连下都下不了了，不知道是我机子的问题还是什么的	BR
无语不了，一直此时无法安装，搞得微信打打不开，想着删了重新下一个，结果连下了，不晓得是我机子问题还是的	BR
无语，更新不了一直此时安装，搞得微信打也打不开，想着删了重新下一个，结果连下都下不了了，不晓得是我的问题还是的	BR
无语，更新，一直显示此时无法安装，打也打不开，想着删了重新下一个连下都下不了了，不晓得是我机子的问题还是的	BR
无语了，更新不了，一直此时无法安装，搞得微信打也打不开，想着删了重新下，结果连下下不了了不晓得是我机子的问题还是什么	BR
无语了，更新不了，一直表明此时无法安装，搞得QQ打也打不开，想著删了重新下一个，结果连下都下不了了，不知道是我机子的问题还是什么的	BR
无语了更新，一直显示此时安装，微信打也，想着删了重新下一个，结果下不了了不晓得是我机子的问题还是	BR
无语了，更新不了，一直表明此时无法配备，搞得QQ打也打不开，想着删了重新下一个，结果连下都下不了了，不知道是我机子的问题还是什么的	BR
，更新之后用4g根本用	BF
垃圾，之后用4g根本用不了	BF
废物，更新之后用4g根本用不了	BF
垃圾，更新之后用4g	BF
污水，更新之后用4g根本用不了	BF
很听说，最近换工作了开始使用钉钉，整体觉得还挺好的	GF
很早就却说了，但最近换工作了才开始使用钉钉，总体觉得还挺好的	GF
很早就听闻了，但最近换工作了才开始使用钉钉，总体觉得还挺好的	GF
初步上手感觉不错，一个版本好不少	GF
初步手感觉不错版本好不少	GF
初步上手感觉不错，比上一个标准版好不少	GF
初步手感觉不错，比上版本好不少	GF
新版我的，界面改的乱七八糟的，什么都找不到，不像以前那么一目了然，还是喜欢之前版本	BF
新版，我的，编辑器改的乱七八糟的，什么都找不到，不像以前那么一目了然，相比之下还是钟爱之前版	BF
新版，我的，的乱七八糟，什么都找不像以前一目了然，相比之下还是喜欢版本	BF
新版，的，界面的乱七八糟的，都找不到不像以前那么一目了然还是喜欢版本	BF
新版，我的，视窗改的乱七八糟的，什么都找不到，不像以前那么一目了然，相对而言还是讨厌之前版本	BF
以前的新浪云电子音乐UI页面都很完美，要什么直接点，现在都是为了会员，页面都大改，没有以前的精致，不钟爱	BF
的云页面都很完美，要什么直接点现在都为了会员，页面都，没有以前的精致，不喜欢	BF
的音乐UI都很完美要什么直接点，都是会员，页面大改，以前的，不	BF
以前的网易云音乐UI页面都完美，要什么直接点，现在都是会员，都没有以前的不喜欢	BF
以前的网易云古典音乐界面页面都很完美，要什么直接点，现在都是为了会员，页面都大改，没有以前的华丽，不喜欢	BF
新版本的聊天？文件呢？原来发送过的图片、、文件等点开聊天文件一目了然，现在居然没有了。找发的文件手都要了	BR
新版本的聊天室文档呢？聊天室文档呢？原来推送过的照片、视频、文档等点开聊天室文档一目了然，现在居然没有了。找很久以前发的文档手都要翻断了	BR
新版本的闲聊文档呢？闲聊文档呢？原来发送过的截图、音频、文档等点开闲聊文档一目了然，现在居然没有了。找很久以前发的文档手都要翻断了	BR
新版本的聊天文件呢？聊天文件呢？原来发送过的图片、视频、等聊天文件一目了然，现在居然没有了找很久以前发的手都要翻断了	BR
新版本的闲聊文件呢？闲聊文件呢？原来发送给过的图片、片段、文件等点开闲聊文件一目了然，现在居然没有了。找远古时代发的文件手都要翻断了	BR
新版本的聊天？聊天文件呢？原来发送过、视频、文件等点开聊天文件，现在居然了很久以前的手都要翻断了	BR
新版本的呢？聊天？发送的图片、视频、文件等点开聊天文件一目了然，居然没有了。找很久以前发的文件手要翻断了	BR
新版本的聊天文件呢？聊天文件呢？原来发送过的、视频、等点开聊天文件一目了然，现在居然没有了。很久以前的文件手都要翻断了	BR
新版本的聊天室文件呢？聊天室文件呢？原来发送给过的照片、视频、文件等点开聊天室文件一目了然，现在居然没有了。找远古时代发的文件手都要翻断了	BR
感受完后满心期待，希望能越来越好	GF
体验满心期待，希望能越来越	GF
体验完后满心期待，希望能愈加好	GF
体验完后满心期待，希望越来越	GF
新版本的录音带的样式没有之前的好，改成这样有什么现实意义呢。吃饱没事做的脑残人想这些没新颖的	BF
新版本的录制的花纹没有之前的好，改成这样有什么象征意义呢。吃饱没事做的脑残人想这些没实用的	BF
新版本的录音的样式没有之前好，改成这样有什么呢。吃饱没事的人想这些没的	BF
新版本录音的样式没有之前的好改成这样有什么意义呢。吃饱做的脑残人想这些没实用的	BF
新版本的录音的式样没有之前的好，改成这样有什么实际意义呢。吃饱没事做的脑残人想这些没新颖的	BF
这是我听过最好的现代舞播放器	GF
这是我听过最好的音乐创作播放器	GF
这是我听过最好音乐	GF
是我听过最好的音乐播放器	GF
这是我听过最好音乐播放器	GF
Iphone6s，后台关闭后才有消息通知，那么多程序员难道是猪吗	BR
Iphone6s，后台关闭后，打开软件才有消息，那么多程序员猪吗	BR
Iphone6s，后台关闭后，打开软件才有消息通告，那么多编程难道是猪吗	BR
Iphone6s，后台后，打开软件才有消息通知，那么多程序员难道是猪吗	BR
Iphone6s，后台关闭后，锁上软件才有消息通知，那么多程序员难道是羊吗	BR
Iphone6s，后台关停后，打开软件才有最新消息通知，那么多程序员难道是猪吗	BR
Iphone6s，后台关闭后，打开软体才有消息通知，那么多程序员难道是鸡吗	BR
Iphone6s后台关闭，打开软件才有消息通知，那么多程序员难道是猪吗	BR
Iphone6s，后台关闭后，打开软件才有最新消息通知，那么多开发人员难道是猪吗	BR
希望日功能可以放到更容易找位置	ADV
希望日晚报功能可以放到更容易找的位置	ADV
希望日时报功能可以放到更容易找的位置	ADV
日报功能可以放到更容易找的位置	ADV
希望日报功能可以置于更容易找的位置	ADV
希望报功能可以更容易的	ADV
日报放到更容易找的位置	ADV
希望同年报功能可以放到更容易找的位置	ADV
希望报功能放到更容易找位置	ADV
建议加一个建立群聊时候需要人的功能，莫名其妙被拉进群很的，有些都是一般朋友群还不好意思推出，真的很	ADV
建议加一个建立群聊的人同意的功能，的被拉进一个群很恶心的，有些都一般朋友被拉进一个群还不好意思推出，真的很	ADV
建议加一个时候需要人同意的功能，莫名其妙被拉进一个群很恶心的，有些都是一般朋友被拉进还不好意思推出，很	ADV
建议加一个创建群聊的时候需要人同意的机能，莫名其妙的被拉进一个群很恶心的，有些都是一般朋友被拉进一个群还不好意思发布，也许很不爽	ADV
建议加一个建立群聊的时候需要人准许的功能，莫名的被推入一个群很恶心的，有些都是一般朋友被拉进一个群还不好意思推出，真的很诧异	ADV
建议加一个建立群聊的时候需要人同意的功能，莫名其妙的被拉进一个群很恶心的，有些都是一般朋友被拉进一个群推出，真的	ADV
建议加一个建立群聊的时候需要人一致同意的功能，莫名的被拉进一个群很恶心的，有些都是一般同事被拉进一个群还不好意思推出，真的很难受	ADV
加建立群聊的时候需要人的功能莫名其妙的群很恶心有些是一般朋友被拉进还不好意思，真的很不爽	ADV
一个建立群聊时候需要人同意的功能，莫名其妙被一个群很恶心的，有些都是朋友被拉进一个群还不好意思推出，真的很	ADV
建议加一个构建群聊的时候需要人同意的基本功能，莫名的被拉进一个群很恶心的，有些都是一般朋友被拉进一个群还不好意思推出，难道很不爽	ADV
搞不懂国内很多大集团的iTunes总是手机的放大版，丑到死，很多时候还表明不全，专门为iPad适配一个iTunes很难吗	BF
搞不懂国内很多大公司的AppStore总是手机的放大国际版，丑到死，很多时候还表明不全，专门为iPad适配一个AppStore很难吗	BF
搞不懂国内大公司的App总是手机的放大版，很多时候还显示不全，为适配一个App很难吗	BF
搞不懂国内很多大集团的App总是手机的放大版，丑到死，很多时候还表明不全，专门为Apple适配一个App很难吗	BF
搞不懂国内很多大的App总是手机的放大版，丑到死，很多还显示不全，专门为iPadApp吗	BF
第二次给苹果公司的软件赞扬，实在是忍无可忍了。更新了新版本，但是集分宝不能还信用卡了，操作上完全不如上一版本，能不能赶紧健全阿。或者出个更新太差用，能后退版本的插件阿。疯了。银联彻底瘫痪	BF
第一次给苹果的软件评价，实在忍无可忍了。了新版本，但是集分宝不能还信用卡了，操作上完全一版本，不能赶紧完善阿。或者出个更新不好用，能后退的插件阿。疯支付宝彻底瘫痪	BF
第一次给Nexus的软件包评价，恐怕是忍无可忍了。更新了新版本，但是集分宝不能还信用卡了，操作上完全不如上一版，能不能赶紧完善阿。或者出个更新不好用，能后撤版的插件阿。疯了。京东彻底瘫痪	BF
第二次给苹果的软件赞扬，实在是忍无可忍了。更新了新版本，但是集分宝不能还信用卡了，操作上完全不如上一版，能不能赶快规范阿。或者出个更新不好用，能后撤版的插件阿。疯了。支付宝彻底瘫痪	BF
苹果软件评价，是忍无可忍了。了新版本集分宝不能还信用卡了，操作上完全不如上一版本，能不能赶紧阿。或者出个更新用能后退的插件阿了支付宝彻底瘫痪	BF
为什么ios不能改微信提示音，求解决啊	ASK
为什么ios模块不能改微信提示音了，求解决啊	ASK
为什么ios子系统不能改微信提示音了，求解决啊	ASK
为什么ios系统不能改微信，解决啊	ASK
为什么ios管理系统不能改微信提示音了，求解决啊	ASK
为什么ios系统不能微信提示音了，解决啊	ASK
ios系统不能改微信了，求解决啊	ASK
为什么ios系统不能改微信提示音了，求消除啊	ASK
为什么ios系统不能改微信提示音了，求化解啊	ASK
为什么ios系统微信提示音，求解决啊	ASK
为什么系统不能改微信提示音了，求解决啊	ASK
为什么ios系统不能改微信提示音了，求破解啊	ASK
为什么ios信息系统不能改微信提示音了，求解决啊	ASK
为什么ios系统不能改QQ提示音了，求解决啊	ASK
为什么系统不能微信提示音，求啊	ASK
为什么ios系统不能微信了，解决啊	ASK
为什么ios系统不能改提示音了，求解决啊	ASK
为什么ios系统不能提示音，求解决啊	ASK
为什么ios系统改了，求解决啊	ASK
为什么ios系统不能了，求解决啊	ASK
为什么ios系统改微信提示音了，求解决	ASK
为什么ios系统不能改微信提示音了，求解决问题啊	ASK
为什么ios系统改微信提示音了，求解决啊	ASK
期望微信可以缩减一个，批量移除好友的基本功能，一间公司工作，整个公司的人或是其他方面的相关人员都要加上好友了，等离开这家公司这个好友要一个个移除真的很麻烦。我每个月谁都要抽筋，删的想吐	ADV
期望微信可以增加一个，批量删除挚友的特性，一家集团工作，整个集团的人或是其他方面的技术人员都要加上挚友了，等离开这家集团这个挚友要一个个删除真的很麻烦。我每个同月谁都要抽筋，删的想吐	ADV
希望微信可以大大增加一个，批量删掉好友的系统，一间集团工作，整个集团的人或是其他方面的人员都要加上好友了，等离去这家集团这个好友要一个个删掉真的很麻烦。我每个月谁都要抽筋，删的想吐	ADV
希望微信增加，批量好友的功能，一家公司工作，整个的人其他方面的人员要加上好友了，等离开这家公司这个好友要一个个删除真的很麻烦。我每个月谁都要抽筋，删的想吐	ADV
希望微信增加，批量删除好友的功能一家公司工作，公司的人其他方面的人员都要加上好友了，等公司这个好友删除真的很麻烦。我谁都的想吐	ADV
期望微信可以减低一个，批量删去好友的功能，一家公司工作，整个公司的人或是其他方面的技术人员都要加上好友了，等返回这家公司这个好友要一个个删去其实很麻烦。我每个月谁都要抽筋，删的想吐	ADV
微信可以增加一个，批量删除好友功能一家公司工作，整个人或是其他方面的人员都要加上好友了，等离开这家公司这个好友要删除真的很麻烦。每个月谁都抽筋删的想吐	ADV
希望微信可以增加一个删除好友的，一家工作，整个公司的人或是其他方面的人员都要加上了，等离开这家公司这个要一个个删除真的麻烦。每个谁都要抽筋，删的想吐	ADV
希望QQ可以不断增加一个，批量封禁好友的功能，一家公司工作，整个公司的人或是其他方面的技术人员都要加上好友了，等逃离这家公司这个好友要一个个封禁真的很麻烦。我每个月谁都要扭伤，删的想吐	ADV
希望QQ可以增加一个，批量封禁好友的系统，一家公司工作，整个公司的人或是其他方面的人员都要加上好友了，等离去这家公司这个好友要无数个封禁真的很麻烦。我每个同月谁都要抽筋，删的想吐	ADV
什么破软件，，功能也不好，	BF
什么破插件，侵犯隐私，功能也不好用，差评	BF
什么破软件，侵犯隐私，功能也太差用，差评	BF
越更新越不好用iOS都找不到停用漂流瓶的功能了	BF
愈更新愈不好用了，iOS都找不到停止使用漂流瓶的功能了	BF
越更新用了iOS都找不到停用漂流瓶的功能了	BF
越更新越太差用了，iOS都找不到停用漂流瓶的基本功能了	BF
越更新越不好用了，Mac都找不到停用漂流瓶的基本功能了	BF
越越不好用了，iOS都找不到停用漂流瓶的功能了	BF
你以为你是必需品么？说涨价就涨价，还涨那么多，已经不昂贵了还涨价，还是用优酷吧，优酷是良心商品，企鹅就是各种抄袭各种心黑，阿里在慈善事业没终止过，你却从未开始过	BF
你以为你是生活必需品么？说价格上涨就价格上涨，还涨那么多，已经不低廉了还价格上涨，还是用优酷吧，优酷是良心系列产品，企鹅就是各种剽窃各种心黑，阿里在公益没停止过，你却从未开始过	BF
你以为你是生活必需品么？说涨价涨价还涨那么，已经不便宜了涨价，还是用优酷吧，优酷产品，企鹅就是各种抄袭心黑阿里在公益事业没停止过，你从未开始过	BF
你以为你是必需品么？说涨价就涨价，还涨那么多，已经不贵了还涨价，还是用土豆网吧，土豆网是良知产品，企鹅就是各种剽窃各种心黑，阿里在公益事业没停止过，你却从未开始过	BF
的拉进百人群我银行卡不能绑定，很麻烦，有些通知风险很大，改进	BF
我练车的教头拉我进百人群结果我没有银行卡所以不能存取，很麻烦，有些通知收不到，风险很大，期望改进	BF
我练车的拉我进百我没有银行卡所以不能绑定，很麻烦，有些通知，，改进	BF
我练车的领队拉我进百群体结果我没有银行卡所以不能存取，很麻烦，有些通知收不到，风险很大，希望改进	BF
我练车的教练拉我进百群体结果我没有银行卡所以不能存取，很麻烦，有些通知收不到，风险很大，希望改良	BF
一进来就是可能人推荐关不掉，恶心	BF
一就是可能认识的人的推荐，关不掉，恶心	BF
一进来就是可能认识的人的推荐，关不掉，头晕	BF
钉钉不仅日常社交，更办公轻松便捷，	GF
钉钉不仅满足，重要使办公轻松便捷，灰常棒	GF
钉钉不仅满足日常社交，更重要使办公随心所欲便捷，灰常棒	GF
钉钉不仅满足日常SNS，更重要使办公轻松便捷，灰常棒	GF
如同原文，每当我连上WiFi看片段但是却网际网路不稳定转换到自己网际网路的时候，我不在意一点流量就点击了流量播出，可你却为什么要我再看一遍电视广告？90秒钟的，特别是在月底的时候，我敢说我没那没多流量挥霍了，看个视频信号不稳定，我就得反复看电视广告，WiFi，4G，WiFi=90秒钟电视广告，每天这样我就会关掉片段，直到什么时候我淡忘这件事儿，然后又耗费我心灵中的90秒钟进入片段，如果运气好我还能直接再进入一段电视广告，我可去你的吧	BF
如同，连上wifi视频但是却网络不稳定切换到自己网络时候，不在乎流量就点击了播放，可却为什么我再广告？90秒的，特别是在的时候，敢说没那没多流量挥霍了，视频信号不稳定，我就得反复看广告，wifi，4G，wifi=90广告，每次这样我就会关掉视频，直到什么时候淡忘这件事，然后又花费生命中的90秒进入视频运气还能直接再进入一段广告，我可去你的吧	BF
如同副标题，每当我连上wifi看录像但是却因特网不平稳转换到自己因特网的时候，我不在意一点流量就点击了流量首播，可你却为什么要我再看一遍广告？90秒的，特别是在月底的时候，我敢说我没那没多流量挥霍了，看个视频信号不平稳，我就得反复看广告，wifi，4G，wifi=90秒广告，每天这样我就会关掉录像，直到什么时候我淡忘这件小事，然后又花掉我灵魂当中的90秒进入录像，如果运气好我还能直接再进入几段广告，我可去你的吧	BF
如同书名，每当我连上Wifi看截图但是却网络不平稳切换到自己网络的时候，我不在意一点流量就点击了流量播送，可你却为什么要我再看一遍商业广告？90分钟的，特别是在月末的时候，我敢说我没那没多流量挥霍了，看个视频信号不平稳，我就得反复看商业广告，Wifi，4G，Wifi=90分钟商业广告，每天这样我就会关掉截图，直到什么时候我淡忘这件事儿，然后又耗费我生命之中的90分钟进入截图，如果运气好我还能直接再进入一段商业广告，我可去你的吧	BF
提款小朋友给赚了钱，消息看完了还有提示，再看还有提示，总是有个小红点在那怎么也去不掉	BR
转账小伙伴赚了钱，消息了还有提示，看还有，总是有个小红点在那怎么去不掉	BR
转账小伙伴给赚了钱，消息看过了还有提示，再看还有提示，总是小红点在那怎么也去不掉	BR
转账小朋友给赚了钱，最新消息看完了还有提示，再看还有提示，总是有个小红点在那怎么也去不掉	BR
转账小伙伴，看过了还有提示，再看还有提示，总是有个那也去不掉	BR
转账小伙伴给赚了钱看过还有提示再看还有提示，总是小红点在那怎么也去不掉	BR
充值小伙伴给赚了钱，最新消息看完了还有提示，再看还有提示，总是有个小红点在那怎么也去不掉	BR
最近发现QQ，在输入文字时，聊天记录全白，信息点击发送后消失，强制退出后可以恢复正常，期望改进	BR
最近发现微信，在输入文字时，聊天记录全白，发送后消失，强制后可以，希望改进	BR
最近发现微信，在输入书写时，聊天记录全白，数据点击发送后消失，强制性退出后可以恢复，希望改进	BR
最近发现微信，在输出汉字之前，聊天记录全白，信息点击发送后消失，强制退出后可以恢复，希望改进	BR
最近，在输入文字时聊天记录全白，发送后，强制退出恢复，希望改进	BR
最近发现微信，在输入文字时，聊天记录，信息点击发送后消失，强制后可以恢复，希望改进	BR
最近发现微信，输入文字，，信息点击发送后消失，强制退出后可以恢复，希望改进	BR
最近辨认出微信，在读取文字时，聊天记录全白，信息点击发送后消失，强制退出后可以恢复，期望改进	BR
最近发现微信，在输入文字时，全白信息发送后消失强制退出后可以，	BR
发现微信，输入文字时，聊天记录全白信息发送后消失，强制可以，希望改进	BR
最近发现微信，在输入文字时，聊天记录全白，信息点击发送后消失，强制性退出后可以恢复正常，期望改进	BR
同样的版本，我的QQ就没有新表情，是电脑版本问题呢	BR
同样的版本我的微信就新表情，手机版本问题呢	BR
同样的标准版，我的微信就没有崭新表情，是手机标准版问题呢	BR
同样的版本，我的QQ就没有崭新表情，是手机版本问题呢	BR
同样的版本，我的就没有新表情，是问题呢	BR
同样的版本，我的微信就没有新神情，是智能手机版本问题呢	BR
同样的版本，我的微信就没有崭新面容，是手机版本问题呢	BR
非常好用的软件，便利，赞赞赞	GF
非常好用的软件，很方便，赞赞赞	GF
好用的软件，很便利，赞赞赞	GF
非常好用软件，很便利赞赞赞	GF
我挺喜欢这个视频软件的，你们太败好感了啊啊啊，本来都忘记支持这个事情你这我就想了。啥啥不行第一名，你们了，对了，肖战侮辱女性的事情有图有真相承认的，你们搁这洗嘛呢自己不是女的	BF
我挺喜欢这个录像软件的，但是你们实在太败好感了啊啊啊啊，本来都想到鹅支持他这个事情的你这一提我就想卸载了。干啥啥不行败坏好感第七名，你们太牛了，对了，肖战侮辱男性的事情都有图有谎言乐迷还否认了的，你们还搁这洗嘛呢，你自己不是女的吗	BF
我挺喜欢这个视频软件的但是你们真的太败好感啊啊啊，本来都支持他这个事情的你这我就卸载了。干啥不行好感太牛了肖战侮辱的事情都有图有粉丝还承认了的，还搁这洗嘛呢，你自己不是女的吗	BF
我挺喜欢这个截图软件产品的，但是你们真的太败爱意了啊啊啊啊，本来都忘记鹅支持他这个事儿的你这一提我就想要卸载了。干啥啥没用败坏爱意第一名，你们太牛了，对了，肖战侮辱男性的事儿都有图有真相粉丝还声称了的，你们还搁这洗嘛呢，你自己不是女的吗	BF
我挺喜欢这个的但是你们真的太败好感了啊啊啊，本来都忘记支持这个的你一提就卸载了。啥啥败坏好感，你们太牛了，对了肖战侮辱女性事情有图有真相粉丝还承认了的，还洗嘛你自己不是女吗	BF
更新习惯了功能性可以增强，但是版面不要动	ADV
不要更新我们生活习惯了，功能性可以增强，但是版面就不要动了怎么样	ADV
习惯了，功能性可以，但是版面动了好不好	ADV
更新我们习惯了可以增强，但是版面就不要动了	ADV
不要更新我们习惯了，功能性可以增强，但是就了	ADV
不要更新我们生活习惯了，功能性可以进一步提高，但是版面就不要动了好不好	ADV
我们习惯了，功能性增强，但是版面就不要动了	ADV
不要更新我们习惯了，功能性可以进一步提高，但是版面就不要动了怎么样	ADV
没有提意见地方吗？我在审批报销页面很渣快捷查找出每笔费用多少怎么就不能把明细显示出来啊	ADV
叮叮没有提意见的地方吗？我想在报销的记录页面就很渣，无法快捷查找出费用多少，怎么就不能把明细显示出来。	ADV
叮叮没有提意见的地方吗？我想说在审批程序报销的记录首页就很渣，无法快捷搜寻出每笔费用多少，怎么就不能把明细表明出来。啊	ADV
叮叮没有提意见的地方吗？我想写道在审核报销的记录关键字就很渣，无法快捷查找出每笔支出多少，怎么就不能把明细显示出来。啊	ADV
叮叮没有提意见的地方吗我说在审批报销的记录页面就很渣，无法快捷查找出每笔费用多少，怎么就把明细显示出来。	ADV
叮叮没有提意见的地方吗？我想写道在核准报销的记录页面就很渣，无法便捷查找出每笔开销多少，怎么就不能把明细显示出来。啊	ADV
叮叮没有提意见的地方吗？我想写道在审批程序报销的记录页面就很渣，无法便捷查找出每笔费用多少，怎么就不能把明细表明出来。啊	ADV
叮叮提意见的地方吗我想说在审批报销的页面就很渣，无法快捷查找出每笔费用多少怎么就不能明细显示出来。啊	ADV
叮叮没有提意见地方吗？想说在审批的记录就很渣，快捷查找出每笔多少，怎么就不能把明细显示出来啊	ADV
你面世这基本功能去玩限制时间。你这不逼自己玩很多人去用非官方客户端吗	BF
你推出这特性去玩限制时间。你这不逼自己玩很多人去用非官方服务器吗	BF
你推出这系统去玩限制时间。你这不逼迫自己玩很多人去用非官方客户端吗	BF
你推出功能去玩限制。你这不逼自己玩人去用非官方客户端吗	BF
你推出这功能去玩限制时间。你这不逼自己很多人去非官方吗	BF
你推出这功能去限制时间。这不自己玩很多人去用非官方客户端吗	BF
会员登录，点击微信，没反应，iPhone7p，速度速度解决问题	BR
会员登录，点击微信，没反应，速度速度解决	BR
会员登录，微信，没反应iPhone7p速度速度解决	BR
会员登录，点击微信，，iPhone7p，速度速度解决	BR
会员登录，点击微信，没反应，iPhone7p，速度速度妥善解决	BR
会员登录，点击QQ，没反应，iPhone7p，速度速度解决	BR
会员登录，点击，，iPhone7p，速度速度解决	BR
会员登录，点击微信没反应iPhone7p，速度解决	BR
发朋友圈，视频，不能长辣鸡玩意转账提现还要身份证	BF
发朋友圈，视频，不能宽，辣鸡狗玩意儿转账提现还要身份证	BF
发朋友圈，视频，不能，辣鸡狗玩意转账提现还要身份证	BF
发朋友圈，截图，不能长，辣鸡狗玩意转账提现还要驾驶证	BF
钉钉越来越成熟，更新已经成为习惯电话语音导航功能厉害了，希望越来越好人在，也会给多的工作伙伴	GF
钉钉越来越成熟，及时更新已经成为生活习惯，办公电话语音导航系统特性厉害了，期望越来越好，身边人都在用，也会推荐给更多的工作伙伴	GF
越来越成熟，及时成为习惯办公电话语音功能厉害了，希望越来越好，身边人都用，也推荐更多的工作伙伴	GF
钉钉愈发成熟，及时更新已经成为习惯，办公来电语音导航功能难受了，希望愈发好，身旁人都在用，也会推荐给更多的工作伙伴	GF
挺好用的GG国际长途呢	ASK
挺好用的，但是GG说好的国际性长途呢	ASK
挺好用但是GG说好的国际长途呢	ASK
挺好用的，但是GG说好的长途呢	ASK
挺好用的，但是GG说好长途呢	ASK
挺好用，但是GG的国际长途呢	ASK
挺好用的，GG说好的国际长途呢	ASK
挺好用的，但是GG说好国际长途呢	ASK
挺好用的，但是说好的长途呢	ASK
挺好用的，但是GG说好长途	ASK
的，GG说好的长途呢	ASK
的但是GG说好的国际长途呢	ASK
挺好用的，GG的国际长途	ASK
挺好用的，但是说好的国际长途呢	ASK
为什么更新不了支付宝而且之前的我现在用不了	BR
我为什么更新不了PayPal，而且之前的标准版我现在也用不了	BR
我为什么更新不了网银，而且之前的标准版我现在也用不了	BR
我为什么更新不了PayPal，而且之前的版我现在也用不了	BR
我更新不了支付宝，而且之前的版本现在也用不了	BR
我为什么更新不了支付宝，而且之前的版本现在也用不了	BR
我为什么更新支付宝，而且之前的版本现在也不了	BR
我为什么不了支付宝，而且之前的版本我现在也用不了	BR
我为什么更新不了京东，而且之前的标准版我现在也用不了	BR
一切都很满意，除了借记卡的自动还款功能还不是非常细化，尤其是农行的	BF
一切都很满意，除了信用卡的自动还款功能还不是非常不断完善，尤其是民生银行的	BF
都很满意，除了信用卡的还款还非常完善，尤其是农行的	BF
一切都很满意，信用卡的还款功能还非常，尤其是农行的	BF
一切都很满意，信用卡的还款功能还不是非常完善，尤其是农行的	BF
看见鬼啊，看下载下来的录像都要配74分钟的广告，还每集都是，有完没完	BF
看见鬼啊，看下载下来的截图都要配74分钟的广告宣传，还每一集都是，有完没完	BF
看见鬼啊，看下载下来的视频都配74分钟的广告，还每一集是，有完没完	BF
其他都非常好，版权问题	BF
其他都非常好，就是发行权问题啊	BF
其他都非常好，就是版税问题啊	BF
钉拍打卡时给滤镜	ADV
强烈要求兄自拍打给个滤镜	ADV
强烈要求绑兄自拍打卡时给个滤镜	ADV
强烈要求钉兄自拍打卡时给个感光	ADV
钉兄自拍打卡时给滤镜	ADV
强烈要求钉兄自拍打卡时给个HDR	ADV
强烈要求钉兄自拍打给个滤镜	ADV
垃圾软件，广告时间长还天天弹窗口	BF
垃圾时间长，还天天弹窗口	BF
垃圾软件，广告时间短，还天天弹窗口	BF
废弃物软件，广告时间长，还天天弹窗口	BF
很不痛恨各种告诫弹屏，比如别人运动邀请我也开建之类的告诫，各种与我不相干的告诫，超痛恨。还没处过滤，我只想接受跟我工作有关的告诫都不行。索性把整个软件的通知都关了	BF
很不喜爱各种提醒弹屏，比如别人运动邀请我也投入使用之类的提醒，各种与我不相干的提醒，超喜爱。还没处过滤，我只想接受跟我工作有关的提醒都不行。索性把整个应用程序的通知都关了	BF
很不喜欢各种提醒弹屏，比如别人运动应邀我也启用之类的提醒，各种与我不相干的提醒，超讨厌。还没处过滤，我只想接受跟我工作有关的提醒都没用。索性把整个软件的通告都关了	BF
很不各种提醒弹屏比如别人运动邀请我也开通提醒，与我的提醒，超讨厌。还没处屏蔽，我只想接受跟我工作有关的提醒不行。把软件通知都关了	BF
天天。要充VIP，付费观看。一天推几十个消息。，片中片尾暂停都TM的是。电视剧，老要付费搞什么观看	BF
天天恰钱。要充，还要付费观看。一天几十个消息。，片中，片尾暂停TM是。电视剧，，付费，去什么超前观看	BF
天天恰钱。要充VIP，还要付费观赏。一天推几十个消息。背景音乐，剧中，片尾，暂停都TM的是广告。剧集，动漫，老要付费，去搞什么超前观赏	BF
天天恰钱。要充VIP，观看。一天推消息。，，片尾，暂停都TM的是广告电视剧，，老要付费，去搞什么超前观看	BF
天天恰钱。要充VIP，还要付费观看。一天推十几个消息。片头，片中，片尾，停止都TM的是商业广告。电视剧，ACG，老要付费，去搞什么超前观看	BF
天天恰钱。要充VIP，还要付费观看。一天推几十个最新消息。片尾，片中，片尾，停止都TM的是广告。古装剧，动漫，老要付费，去搞什么超前观看	BF
新版什么鬼，口令红包都不了了	BR
新版什么妖怪，口令红包都领不了了	BR
什么鬼，口令红包领不了	BR
新版什么鬼，口令红包都领	BR
新版口令红包都不了了	BR
新版什么，口令都领不了了	BR
为了，买个6plus来刷分，就是这么任性。看不起，歧视。物极必反	BF
为了wp，来刷分就是这么任性。看不起wp歧视用户。物极必反	BF
为了wp，买个6plus来刷分，就是这么任性。瞧不起wp，歧视使用者。物极必反	BF
为了wp，买个6plus来刷分，就是这么天真。看不起wp，歧视性用户。物极必反	BF
试用了够简捷商务，唯一缺点当然是用户数量。我同事上面六个人在用	BF
试用了一下，这么简捷商务，唯一缺点当然是用户数量。不过我同事上面已经有七个人在用	BF
试用了一下，够简便商务，唯一缺点当然是用户量。不过我同事上面已经有六个人在用	BF
污水相当污水不是分组里的人都不见踪影了，就是动不动就聊天记录没了，相当污水了，好想爆粗口，相当污水了	BR
太垃圾不是分组里的都不见了，就是动不动就聊天记录没，太垃圾，想爆粗，太垃圾了	BR
垃圾分组里的人都不见了，就是动不动就聊天记录没垃圾了，好爆粗口，太垃圾了	BR
废弃物太废弃物不是分组里的人都不见踪影了，就是动不动就聊天记录没了，太废弃物了，好想要爆粗口，太废弃物了	BR
垃圾太垃圾不是的人都不见了，没了，太垃圾了想爆粗，垃圾	BR
垃圾很垃圾不是分组里的人都不见踪影了，就是动不动就聊天记录没了，很垃圾了，好想要爆粗口，很垃圾了	BR
垃圾相当垃圾不是分组里的人都不见踪影了，就是动不动就聊天记录没了，相当垃圾了，好不想爆粗口，相当垃圾了	BR
垃圾不是里的人都不见了，就是动不动聊天记录没了，太垃圾了，好想爆粗口，太垃圾了	BR
某个引入没了有点可惜	BF
导入没可惜	BF
导入没了可惜	BF
朋友圈的相册有一键删除和好友或者删除功能	ADV
希望朋友圈的相册有一键移除朋友圈和好友或者多选移除功能	ADV
希望朋友圈的相册有一键删除和或者多选删除功能	ADV
希望朋友圈的相册有删除朋友圈好友或者多选删除功能	ADV
希望朋友圈的相册有一键删去朋友圈和好友或者多选删去功能	ADV
希望朋友圈的相册有一键删除朋友圈和好友或者多选删除机能	ADV
朋友圈的有一键删除朋友圈和好友多选删除功能	ADV
希望朋友圈的相册有朋友圈和好友或者多选删除功能	ADV
希望朋友圈的相册一键删除朋友圈好友多选删除功能	ADV
搞那么多功能，安全性忽视，真恶心，跟微信、美一样，恶心恶心恶心，第一次写评论差评	BF
搞那么多功能，安全性忽视，真恶心，搞得微信、美团结合体一样，恶心恶心，第一次写评论差评	BF
搞那么多功能，安全性低估了，真恶心，搞得跟微信、美团结起来合体一样，恶心恶心恶心，第一次写下评论差评	BF
搞那么多功能，安全性缺少了，真头痛，搞得跟微信、美团结合体一样，头痛头痛头痛，第一次写下评论差评	BF
女朋友推荐就下了个看看，挺好用的，注册了个团队，发现考勤，办公软件类产品的应用都很方便，功能很强而有力，还有电话会议，盛赞	GF
朋友就下了个，挺好用，注册了个团队，发现考勤，办公软件的应用都很方便功能强大，电话会议，赞	GF
推荐就下了个，挺好用，注册了个，发现考勤办公软件类应用很方便很强大，还有电话会议，赞	GF
朋友推荐就下了个看看，挺好用的，申请了个团队，辨认出考勤，办公软件类的应用都很方便，功能很强有力，还有电话会议，盛赞	GF
朋友推荐就下了个看看，挺好用的，申请了个团队，发现考勤，办公应用软件一类的应用都很方便，系统很强大，还有电话会议，赞	GF
用网易和云三个月多，从安卓到iOS，跟QQ微信一样存在于每个手机里。吗很喜欢，期待开发更好玩的功能	GF
用网易云一年多，安卓到iOS，跟QQ微信一样存在于每个手机里真的很喜欢，期待开发更好玩的功能	GF
用网易云一年多，从安卓到Chrome，跟QQQQ一样存在于每个手机里。真的很喜欢，期待开发更好玩的特性	GF
网易云一年，从到iOS，跟QQ微信存在于每个里。真的很喜欢，期待开发更好玩功能	GF
网易云一年，从安卓到，跟一样存在于每个手机里。真的很喜欢，期待开发更的功能	GF
希望能更新更多的偶像剧或者古装剧，再说就是男女女主角颜值高的那类	ADV
希望能更新更多的偶像剧或者古装剧，反正就是男女配角颜值低的那类	ADV
期望能更新更多的韩剧或者古装剧，反正就是男女主角颜值高的那类	ADV
希望能更新更多的偶像剧或者古装剧，反正就是主角颜值高那类	ADV
希望能更新更多的偶像剧或者古装剧，再说就是男女主角颜值差的那类	ADV
希望能更新更多的偶像剧或者古装剧，反正就是男女主角高的那类	ADV
希望能更新更多的偶像剧或者古装剧，反正主角颜值高的那类	ADV
这么多播放软件，的还是云，，喜欢	GF
这么多，最喜欢还是网易云，好用，喜欢	GF
这么多播出软件，最喜欢的还是网易云，好用，喜欢	GF
提个邮政卡的现结果下午提现下午还没到账。还收保证金我也是醉了	BF
提个邮政的现结果上午下午没到账。还收手续费我也是醉了	BF
提个邮政卡现结果上午提现还没到账。还收手续费我也是醉了	BF
提个邮政卡的现结果上午提现清晨还没到账。还收利息我也是醉了	BF
提个邮政卡的结果上午提现下午还没到账。我也是醉	BF
挺好的，内容也	GF
app挺好的，内容也丰富	GF
新版本，带耳机听歌，把均衡器关上，声音太小	BR
新版本，带耳机听歌，把均衡器打开，声音很小	BR
新版本，带耳机，把均衡器打开，声音太小	BR
新版本，带耳机听歌，把均衡器打开，声音太少	BR
新版本，带扬声器听歌，把均衡器打开，声音太小	BR
，带听歌，把均衡器打开，太小	BR
新版本带耳机听歌，把打开，太小	BR
新版本，带耳机听歌，均衡器声音太小	BR
想给朋友发视频没有了，之前保存的临时视频没了，临时保存。位置也用了	BF
不想给朋友发视频没有了，之前留存的临时视频也没了，现在录完也没有临时留存视频。位置也不太好用了	BF
发视频没有了之前保存的临时视频也没了，现在录完也没有临时保存位置也不好了	BF
想要给朋友发录像没有了，之前保存的临时录像也没了，现在录完也没有临时保存录像。位置也不太好用了	BF
我想知道现在QQ哪里可以下，老婆的一天没上QQ了，还有好多事，气死人了	ASK
我想知道现在微信可以下，妈的没上微信了，还有好多事，气死人了	ASK
我不想知道现在QQ哪里可以下，妈的一天没上QQ了，还有好多事，气死人了	ASK
想知道现在微信哪里可以下妈一天上还有好多事，了	ASK
我想知道现在微信哪里可以，妈的一天没上微信了，还有好多事，	ASK
我想知道现在微信哪里，的没上微信了，还有好多，气死人了	ASK
我想知道现在微信哪里可以下，老婆的一天没上微信了，还有好多事儿，气死人了	ASK
我想知道现在QQ哪里可以下，妈的一天没上QQ了，还有好多事情，气死人了	ASK
我想知道现在QQ哪里可以下，爸的一天没上QQ了，还有好多事，气死人了	ASK
我想知道微信哪里下，妈的一天没上了，还有气死人	ASK
我想现在可以的一天没上微信了，还有好多，气死人了	ASK
我想知道现在微信哪里可以下，爸的一天没上微信了，还有好多小事，气死人了	ASK
我知道微信哪里可以，的上微信了还有好多事，气死人	ASK
想知道微信哪里可以下，妈的一天没上微信，还有好多，气死人了	ASK
我想知道现在QQ哪里可以下，妈的一天没上QQ了，还有好多大事，气死人了	ASK
我想知道现在微信哪里可以下，老婆的一天没上微信了，还有好多大事，气死人了	ASK
想知道微信哪里下，妈的一天没上微信还有好多，了	ASK
我知道现在微信可以下，的一天没上微信了，还有事，了	ASK
我不想知道现在微信哪里可以下，妈的一天没上微信了，还有好多大事，气死人了	ASK
我想知道现在QQ哪里可以下，爸爸的一天没上QQ了，还有好多事，气死人了	ASK
我想知道哪里可以下的一天没上微信好多事，气死人了	ASK
我想现在可以下，妈一天没上微信，还有好多事，气死人	ASK
我想要知道现在微信哪里可以下，老婆的一天没上微信了，还有好多事，气死人了	ASK
我想要知道现在微信哪里可以下，妈的一天没上微信了，还有好多事情，气死人了	ASK
想知道哪里下，妈的一天没上了，还有好多事，气死人了	ASK
我想知道现在QQ哪里可以下，妈的一天没上QQ了，还有好多事儿，气死人了	ASK
我想知道微信哪里可以下，上微信了，还有，气死人	ASK
我想知道现在微信哪里可以下，妈的一天没上，事，气死人了	ASK
想知道哪里可以下，妈没上了，还有好多，气死人了	ASK
我想知道现在微信哪里可以下，妈的一天没上微信了，好多事，气死人	ASK
我想现在微信哪里可以下，妈的没微信了，还有好多事了	ASK
我不想知道现在微信哪里可以下，妈的一天没上微信了，还有好多小事，气死人了	ASK
群里都能看到	BF
个人信息居然所有人能看到	BF
隐私居然群里所有人都能看到	BF
桌面调整后看起来更舒适	GF
界面调整后更舒适	GF
介面调整后看起来更舒适	GF
请腾讯截图正视剧粉诉求】拒绝点播、提早结局】现剧关注度讨论度播放数量持续增长，拒绝半路截断】播出日程早有安排，拒绝不顾剧粉意愿强制改动】剧粉作为消费者有权表达自己想法观念，请鹅正视剧粉诉求】拒绝点播、提早结局，及时止损，不要作死	ADV
请腾讯视频认清剧粉诉求】断然拒绝点唱、提前结局】现剧热度探讨度播放量快速增长，断然拒绝半路截断】播出日程早有安排，断然拒绝不顾剧粉意愿强行改动】剧粉作为消费者有权表达自己想法理念，请鹅认清剧粉诉求】断然拒绝点唱、提前结局，及时止损，不要作病死	ADV
请腾讯视频诉求】点播、结局】热度讨论度播放持续增长，拒绝半路截断】播出日程早有，不顾剧粉意愿强行改动】剧粉作为消费者有权表达想法理念，请鹅正视剧粉诉求】拒绝点播、提前结局，及时止损，不要作死	ADV
请视频正视剧粉诉求拒绝点播提前结局现剧讨论播放量持续增长，拒绝半路截断早有安排拒绝不顾剧粉意愿强行消费者有权表达自己想法，请鹅正视剧粉点播、提前结局，及时止损不要作	ADV
请腾讯视频正视剧粉诉求】拒绝点播、提前结局】现剧热度探讨度播放数量快速增长，拒绝半路切断】播出日程早有安排，拒绝罔顾剧粉意愿强行改动】剧粉作为消费者应当表达自己想法理念，请鹅正视剧粉诉求】拒绝点播、提前结局，及时止损，不要作死	ADV
请腾讯视频剧粉诉求】拒绝点播、结局】现剧热度讨论度播放量拒绝半路截断】播出日程早有安排，不顾剧粉意愿强行改动】剧粉作为消费者有权表达自己想法理念，请鹅正视剧粉诉求】拒绝点播、结局，及时，不要作死	ADV
请腾讯视频正视剧粉诉求】拒绝点唱、提前结局】现剧热度进行讨论度播放量稳定增长，拒绝半路截断】播毕日程早有安排，拒绝罔顾剧粉意愿强行改动】剧粉作为消费者有权表达自己想法经营理念，请鹅正视剧粉诉求】拒绝点唱、提前结局，及时止损，不要作死	ADV
请京东视频直面剧粉诉求】回绝点播、提前结局】现剧热度讨论度播放量持续增长，回绝半路截断】播出日程早有安排，回绝罔顾剧粉意愿强行修改】剧粉作为用户有权表达自己想法理念，请鹅直面剧粉诉求】回绝点播、提前结局，及时止损，不要作死	ADV
请腾讯视频直面剧粉诉求】拒绝点播、提前结局】现剧活跃度讨论度播放量强劲增长，拒绝半路截断】播出日程早有安排，拒绝不顾剧粉意愿强行改动】剧粉作为消费者应当表达自己想法观念，请鹅直面剧粉诉求】拒绝点播、提前结局，及时止损，不要作病死	ADV
请腾讯正视剧粉诉求】、】现剧热度讨论度播放量，半路】播出日程，拒绝不顾剧粉意愿强行】剧粉作为消费者自己想法理念，正视剧粉诉求】点播提前结局及时止损，不要作死	ADV
请腾讯正视剧粉诉求】拒绝点播、结局】现剧热度度播放量持续增长，拒绝截断】播出早有，拒绝不顾剧粉意愿强行改动】剧粉消费者有权表达自己，正视剧粉】拒绝点播、提前止损，不要作死	ADV
我长期稳定的会员，因为我喜欢这个播放器更新的快，也。值得推荐	GF
我是长期稳定的会员，因为我钟爱这个音频，更新的快，也稳定。值得推荐	GF
我是长期稳定的，因为我喜欢，更新的快，也。值得推荐	GF
我是长期均衡的会员，因为我讨厌这个播放器，更新的快，也均衡。值得推荐	GF
如果面部能换会更好，其他还是不错的	ADV
如果乳房能换会更好，其他还是不错的	ADV
如果能换会更好，其他还是不错的	ADV
如果皮肤能换会更好，其他不错的	ADV
如果头皮能换会更好，其他还是不错的	ADV
这是我过好好用的应用软件了更新快而且不是很占地方。32个赞，新歌上线，好多都免费听	GF
这是我用过最好好用的应用软件了不是很占地方。32个赞，上线好多都能免费听	GF
这是我用过最好好用的网络设备了更新快而且不是很占到地方。32个赞，新专辑上线，好多都能免费听	GF
是我过最好好的应用软件了更新快不是很32个赞，，好多都	GF
这是我用过最好好用的软件产品了更新快而且不是很占到地方。32个赞，歌曲上线，好多都能免费听	GF
这是我用过最好好用的软件包了更新快而且不是很占到地方。32个赞，MV上线，好多都能免费听	GF
为什么有新版本后要强制性更新啊。不然就不能登录	ASK
为什么有新版本后要强制啊。不然就不能	ASK
为什么新版本后要强制更新。不然就登录	ASK
为什么有新版本后要强行更新啊。不然就不能登录	ASK
有新版本后要更新。不然就不能	ASK
为什么有新版本后要就不能登录	ASK
为什么有新版本后要强制啊。不然不能登录	ASK
为什么有新版本后要强制啊。不然就不能登录	ASK
为什么有新版本后要更新啊。不然就不能登录	ASK
为什么有新版本后要强制更新。不然就不能登录	ASK
为什么有新版本后要强制更新啊。不然不能登录	ASK
为什么新版本后要更新啊不然就不能登录	ASK
为什么有新版本强制更新。不然就登录	ASK
为什么有新版本更新啊。不然就不能登录	ASK
为什么有新版本强制更新啊。就不能	ASK
为什么有后要强制更新啊不然就不能登录	ASK
为什么有新版本后要强制更新啊就不能登录	ASK
为什么强制更新啊。不然就不能登录	ASK
新版本后要强制更新啊。就不能登录	ASK
有时老播放失败，希望一下	BR
有时老是播放失败，希望进一步改进一下	BR
有时老是播放失败，期望改进一下	BR
有时老播放失败，改进一下	BR
有时老是重播失败，希望改进一下	BR
有时老是，希望改进一下	BR
有时老是播放失利，希望改进一下	BR
老是播放失败，希望改进一下	BR
有时老播放失败希望改进一下	BR
有时老是播出失败，希望改进一下	BR
非常不错，其他的听歌app都不用了，只用网易。其实不止古典音乐，网站看新闻我只看网易，有心态的网易。没有被河蟹，期望坚持住	GF
非常，其他的听歌都不用了，只用网易。其实不止音乐，门户网站看新闻我看网易，态度的网易。没有被河蟹，坚持住	GF
非常不错，其他听歌app不用了，只用。不止音乐，门户网站看新闻只看网易，有的。没有被河蟹，希望坚持住	GF
非常不错，其他听歌app都不用网易。音乐，门户网站看新闻我看，有态度的网易。没有被河蟹，希望坚持住	GF
非常不俗，其他的看电视app都不用了，只用网易。其实不止音乐，门户网站看电视新闻我只看网易，有态度的网易。没有被河蟹，希望坚持居住	GF
还是挺好用的	GF
，还是挺好用的	GF
手贱更新后就架设不上了。敢不敢合作开发好了再推出，吼死我了	BF
更新后安装不上了。开发好了推出吼死我了	BF
更新后就安装不上了。敢不敢好了再推出，吼死我	BF
手贱更新后就放置不上了。敢不敢开发好了再面世，吼死我了	BF
下了网易云之后直接把其他的音乐开发工具删了。只希望可以把华晨宇的著作权买下来	GF
下了网易云之后直接把其他的音乐软件删了。只希望可以把华晨辉的著作权买下来	GF
下了网易云直接把删了只可以把华晨的版权买下来	GF
下了网易云之后直接把其他的音乐计算机系统删了。只希望可以把华晨宇的著作权买下来	GF
下了网易之后直接把其他音乐软件删了只希望可以把华晨宇的买下来	GF
开通会员都是新片，开通会员都是老片，烂片。欺骗	BF
不开通会员都是新片，开通会员都是老片，。欺骗消费者	BF
不开通会员都是续集，开通会员都是老片，烂片。欺瞒消费者	BF
不全线通车会员都是新片，全线通车会员都是老片，烂片。欺骗商家	BF
不开通会员都是续集，开通会员都是老片，烂片。欺骗用户	BF
还没有以前好用。现在的搬的总资产看不清，而且明明开销了收入了还不更新。总之太难用了	BR
还没有以前。现在的弄的总资产看不清楚，而且支出了收入了还不更新。总之用了	BR
还没有以前好用。现在弄的总资产看不清楚，而且明明支出了收入了还不更新。总之太难了	BR
还没有以前好用。现在的弄的总资产看不到，而且明明开销了总收入了还不更新。总之太难用了	BR
还没有以前好用。现在的搬的总资产看不清，而且明明预算了收入了还不更新。总之太难用了	BR
还没有以前好用。现在的弄的总资产明明支出了收入了不更新用了	BR
还好用。现在的的，而且明明了收入了还不更新总之太难用	BR
还没有好用。现在的弄的总资产看不清楚，而且明明支出了收入了不更新太难用了	BR
个人隐私什么都看不到。点到个人就卡死	BR
个人信息什么。点到个人就卡死	BR
个人信息什么都看不清。点到个人就卡死	BR
个人信息什么都看不到个人就卡死	BR
个人信息什么都看不清楚。点到个人就卡死	BR
个人信息什么都看不出来。点到个人就卡死	BR
个人信息。点到就	BR
希望加入抖一抖功能，提醒人员消息。ding功能	ADV
希望加入抖一抖功能，告诫人员及时看消息。ding功能不太好用	ADV
加入抖功能，提醒人员及时看消息。ding不好用	ADV
希望加入抖一抖功能，提醒人员及时看消息ding功能不好用	ADV
期望加入抖一抖功能，提醒人员及时看最新消息。ding功能不好用	ADV
希望加入抖一抖功能，告诫人员及时看最新消息。ding功能不好用	ADV
希望加入抖一抖特性，提醒人员及时看消息。ding特性太差用	ADV
加入抖一抖功能，提醒人员看消息。功能不好用	ADV
提高效率是钉钉能为我们做的一件事	GF
提高工作效率是钉钉能为我们做的一件小事	GF
是钉钉能为我们做一件事	GF
工作效率是钉钉能为我们做的一件事	GF
这个视频更好用，也不卡	GF
视频很好用，也不卡	GF
用不卡	GF
腾讯VIP3、想看数部电视剧全跳转去爱奇艺，还让开通爱奇艺VIP才可以看。我有截图，腾讯客服人员还不给反驳。再说2012年的“我们的幸福人生”腾讯都看不了。无力吐槽了，不信的问起597667574要截图，给你们看腾讯客服人员给我的答复都什么	BR
腾讯VIP3、不想看数部电影全跳转去爱奇艺，还让开建爱奇艺VIP才可以看。我有图片，腾讯客服人员还不给解释。再说2012年的“我们的幸福一生”腾讯都看不了。无力吐槽了，不信的问597667574要图片，给你们看腾讯客服人员给我的回复都什么	BR
腾讯VIP3、想几部电影全跳转去奇艺，还让开通爱奇艺VIP可以看有截图，腾讯客服还不解释。再说2012的“的快乐人生”腾讯都不了无力吐槽了，不信的问截图，给你们看腾讯客服给的回复都什么	BR
腾讯VIP3、想看几部全跳转去爱奇艺还开通爱VIP才可以看。我有截图腾讯给。再说年的“我们快乐人生”腾讯都无力吐槽了，的问597667574截图，给你们看腾讯客服我的回复都什么	BR
UCVIP3、想要看几部歌舞片全重定向去爱奇艺，还让投入使用爱奇艺VIP才可以看。我有视频，UC客服还不给表述。再说2012年的“我们的快乐人生”UC都看不了。无力吐槽了，不信的问597667574要视频，给你们看UC客服给我的回复都什么	BR
腾讯VIP3、想看几部电影去爱，还开通爱奇艺VIP才可以。我有截图，腾讯客服不给解释再说2012年的“我们人生”腾讯都看不了。无力吐槽不信的597667574要截图，给你们腾讯我的都什么	BR
腾讯VIP3、不想看几部电影全跳转去爱奇艺，还让启用爱奇艺VIP才可以看。我有截图，腾讯客服还不给解释。再说2012年初的“我们的欢乐爱情”腾讯都看不了。无力吐槽了，不信的追问597667574要截图，给你们看腾讯客服给我的答复都什么	BR
有效的改变了企业目前传统低效沟通，加速了企业的信息化让和更多企业都进入了云和互联的办公方式中了。尤其是钉钉的沟通方面，从基础上颠覆以前的沟通模式。也上优化，越来越。站在用户的角度，更加的功能	ADV
钉钉有效的发生改变了企业目前现代低效的交流现状，快速了企业的信息技术，让我们和更多企业都进入到了云和互联的办公方式之中了。尤其是钉钉的交流方面，真正从基础上摒弃了以前低效的沟通模式。也期盼功能上可以越来越优化，越来越完美。站在用户的角度，更加优化现在的功能	ADV
钉钉有效的改变企业传统低效的现状，加速的信息化，让我们和更多企业都进入到了云互联的办公方式中。尤其钉钉的沟通方面，真正从基础上颠覆了以前低效的。期待可以越来越优化，越来越完美。站在，更加的功能	ADV
钉钉有效的变化了上市公司目前现代低效率的沟通交流现状，加速了上市公司的信息化，让我们和更多上市公司都进入到了云和互联的办公模式中了。尤其是钉钉的沟通交流方面，真正从基础上颠覆了以前低效率的沟通模式。也期待特性上可以越来越强化，越来越完美。站在用户的角度，更加强化现在的特性	ADV
钉钉有效改变了企业目前传统的沟通现状，企业信息化，让我们和多企业都进入到了云和互联办公方式中。尤其钉钉的沟通方面，基础上颠覆了以前低效沟通模式。也上可以越来越优化，越来越完美。在用户的更加现在的功能	ADV
钉钉有效的改变了金融机构目前现代低效率的沟通现状，快速了金融机构的信息技术，让我们和更多金融机构都进入到了云和互联的办公方式中了。尤其是钉钉的沟通方面，真正从基础上颠覆了以前低效率的沟通模式。也期待特性上可以日渐优化，日渐完美。站在移动用户的角度，更加优化现在的特性	ADV
钉钉的改变了企业目前传统低效的沟通现状，加速了企业的信息化，让我们和更都进入到了云和互联的办公中了。尤其钉钉的沟通，真正从基础上低效的沟通模式。期待功能上可以越来越优化，完美。站用户的角度，更加的功能	ADV
钉钉有效的变化了民企目前传统低效的沟通现状，加速了民企的信息技术，让我们和更多民企都进入到了云和互联的办公方式之中了。尤其是钉钉的沟通方面，真正从基础上颠覆了以前低效的沟通模式。也期待机能上可以越来越强化，越来越完美。站在应用程序的角度看，更加强化现在的机能	ADV
钉钉有效的改变了企业目前现代低效率的沟通现状，加速了企业的信息技术，让我们和更多企业都进入到了云和互联的办公方式当中了。尤其是钉钉的沟通方面，真正从基础上颠覆了以前低效率的沟通模式。也期待基本功能上可以愈来愈强化，愈来愈完美。站在用户的角度看，更加强化现在的基本功能	ADV
内容有些，却如24式太极拳口令视屏	BF
内容有些看得了，却冗余不了，如24式简化洪拳带口令的视屏	BF
内容有些看得了，不了，如24式简化带的	BF
内容有些看得了，却磁盘不了，如24式简化螳螂拳带口令的视屏	BF
电台上传的节目要是可以修改名字就更好	ADV
电台上传的节目要是可以修改昵称就更好了	ADV
电台上传节目要是可以修改就更好	ADV
电台上传的节目要是可以修订名字就更好了	ADV
电台上载的节目要是可以修改名字就更好了	ADV
电台上传的节目要是可以修正名字就更好了	ADV
的节目要是可以修改名字就更好了	ADV
电台上传的节目修改名字就更好	ADV
更好用，希望杰伦版权能再回，那些评论都很精彩	ADV
很好用，希望杰伦版权能再回来，那些评论都精彩	ADV
很好用，杰伦能再，那些评论很精彩	ADV
极好用，希望杰伦版权能再回来，那些评论都很精彩纷呈	ADV
用希望杰伦版权再回来，评论都很精彩	ADV
极好用，希望杰伦版权能再回来，那些评论家都很精彩	ADV
用，希望杰伦版权能，评论很精彩	ADV
很好用，希望杰伦版权能再回来，那些文章都很精彩纷呈	ADV
完全盗用广告主隐私信息，还不断发送骚扰短信，甚至请水军刷app信用评级，应该下架	BF
完全盗用用户隐私信息还不断短信，甚至请水军刷app评级，下架	BF
完全还不断发送骚扰短信，甚至水军刷app评级，应该下架	BF
完全盗用用户隐私权信息，还不断发送辱骂短信，甚至请水军刷app评级，应该下架	BF
除了电话功能取消了其他越来越	BF
除了来电功能取消了，其他越来越好用	BF
除了电话功能取消了，其他越来越	BF
除了电话功能取消了，其他更好用	BF
为什么我的银联没有蚂蚁借呗呢	ASK
为什么我的京东没有蚂蚁借呗呢	ASK
为什么我的网银没有蚂蚁借呗呢	ASK
为什么我支付宝没有蚂蚁借呗呢	ASK
为什么我的PayPal没有蚂蚁借呗呢	ASK
为什么我的没有蚂蚁借呢	ASK
我的支付宝蚂蚁借呗呢	ASK
为什么的支付宝没有蚂蚁借呗呢	ASK
为什么我的没有借呗呢	ASK
我的支付宝没有蚂蚁借呗呢	ASK
为什么我的支付宝没有蚂蚁借呢	ASK
为什么我的支付宝没有蚂蚁呗呢	ASK
为什么我的支付宝蚂蚁呢	ASK
为什么的支付宝没有蚂蚁	ASK
为什么我的没有蚂蚁借呗	ASK
为什么我的没有借呗	ASK
为什么的支付宝没有呗呢	ASK
为什么我的支付宝没有借呗呢	ASK
为什么我支付宝蚂蚁借呗呢	ASK
很好，让银行躺着赚钱的了给社会带来更多服务服务。给中国活力	GF
较好，让银行躺着赚钱的时代完结了。给社会带来更多服务服务。给中国经济带来活力	GF
很好，让银行躺着的时代结束了。给带来更多服务服务。给中国经济活力	GF
很好，让躺着赚钱的结束了给社会带来更多服务。给中国经济带来活力	GF
很好，让银行躺着赚钱的时代结束了。给社会带来更多服务项目服务项目。给中国经济带来朝气	GF
升级版对文件支持尤为方便，点赞了	GF
升级版传输文件的支持方便，必须了	GF
升级版对传输文件的支持颇为方便，必须点赞了	GF
升级版对传输文件的支持方便，点赞	GF
我期望微信能直接转发别个的图片和文字，不需要留存图片之后在发朋友圈	ADV
我希望微信能直接转发别个的图片和汉字，不需要留存图片之后在发朋友圈	ADV
我希望能直接转发别个的图片和文字，不需要保存之后在发朋友圈	ADV
希望能直接转发别个的图片和，需要保存图片在发	ADV
我希望微信能直接别个的图片和，不需要保存图片在发朋友圈	ADV
我期望微信能直接转发别个的图片和书写，不需要保存图片之后在发朋友圈	ADV
我期望微信能直接转发别个的相片和文字，不需要保存相片之后在发朋友圈	ADV
我希望能直接的图片和文字，不需要保存图片在朋友圈	ADV
我希望微信能转发别个的和文字不需要保存图片之后在	ADV
的，片源太少	ADV
清晰的不错就是太少	ADV
清晰的不错，就是片源比较少	ADV
清晰，就是片源太少	ADV
清晰的不俗，就是片源太少	ADV
清晰不错就是片源	ADV
清晰的上佳，就是片源太少	ADV
不错，就是片源少	ADV
清晰不错，就是太少	ADV
清晰的不错，就是片源过于少	ADV
花呗账单变得好难用，一目了然比较方便	BF
呗变得，的比较	BF
花呗账单显得好难用，以前一目了然的比较方便	BF
呗账单好难用，以前一目了然比较方便	BF
很好用有些很喜欢的新歌里面也有	GF
很好用有些很喜欢的歌里面也	GF
很好用有些喜欢歌里面也有	GF
很好用有些很喜欢的名曲里面也有	GF
很好用有些很偏爱的歌里面也有	GF
之前版本图片很快，朋友圈图片慢	BF
之前的版保存图片很快，现在保存朋友圈图片，超级慢	BF
之前的版本保存截图很快，现在保存朋友圈截图，超级慢	BF
的版本图片，现在保存图片，超级慢	BF
之前的保存图片很快，现在保存图片超级	BF
2年来最主要的沟通工具，很方便	GF
2年来的交流，很方便	GF
2年来最主要的交流方法，很方便	GF
用了多大软件，真的相对国内软件就是独一无二的存在	GF
用了二年软件，真的软件就是独一无二的	GF
用了二年多大计算机系统，真的相对国内计算机系统就是独一无二的存在	GF
谢谢钉钉全面的呵护我们员工，支持我们有序工作	GF
非常感谢钉钉全面的呵护我们员工，支持我们有序的工作	GF
钉钉全面的呵护我们员工支持我们有序的工作	GF
钉钉全面的呵护我们员工，支持我们有序的工作	GF
比其他音乐离线好用多了啊，资源也多	GF
比其他app好用了资源也多	GF
比其他电子音乐app好用多了啊，资源也多	GF
现在的念书软件都收钱，这个免费小说挺好用得	GF
现在的教书软件都收钱，这个免费小说挺好用得	GF
现在的读书软件收钱，这个免费小说挺好用得	GF
怎么说，百度云是个神奇的东西，它让我花了银子，还花了时间写评论，我还很愿意	GF
怎么说，腾讯云是个神奇的东西，它让我花了钱，还花了时间写下评论者，我还很乐意	GF
个神奇的，它我花了钱，了时间评论，还很乐意	GF
怎么说，云是个神奇的，它我花了钱，还花了时间写，我还很乐意	GF
六不了腾讯视频	BR
苹果六怎么下不了腾讯录像	BR
苹果怎么下不了腾讯视频	BR
谷歌六怎么下不了腾讯视频	BR
苹果怎么下腾讯视频	BR
苹果六怎么下不了腾讯片段	BR
六怎么下不了	BR
如果可以再给一次修改微信号的机会，我一定好好珍惜。	ADV
如果可以再给我一次修改微信号的良机，我一定好好珍视。一次就够了	ADV
如果可以再给我一次修改QQ号的良机，我一定好好珍惜。一次就够了	ADV
如果可以再给一次修改微信号的机会，我一定好好珍惜。一次就够	ADV
可以我一次修改微信机会，我一定珍惜。一次了	ADV
如果可以给我一次修改微信号机会，我一定珍惜。一次了	ADV
不要做这样浪费时间的	ADV
不要做这样的更新了	ADV
不要做这样浪费时间的了	ADV
我们自己的开发工具，越来越棒	GF
我们自己的插件，越来越棒	GF
我们自己的软件，棒	GF
我们自己软件，越来越棒	GF
什么不负好时光？搞了个选秀特别节目然后逼得拳手退赛难道不是负了人家的好时光吗？既然是内定还需要粉丝打投干啥？最好给整个没有点星都能过的评论者	BF
什么不负搞了个选秀节目然后逼选手退赛难道不是负了人家的吗？既然是内定还需要粉丝打投干啥？最好给整个没有点星都能过的评论	BF
不负好时光？然后逼选手退赛不是负人家的？既然是内定还需要粉丝打投干啥？最好给整个没有点星都能过的评论	BF
什么不负好时光？搞了个选秀新闻节目然后逼迫棋手伤退赛难道不是负了人家的好时光吗？既然是内定还需要粉丝打投干啥？最好给整个没有点星都能过的评论	BF
不负？选秀节目然后选手退赛难道不是负人家好时光吗？既然是还需要粉丝打投干？给整个点星能过的	BF
看了几年腾讯，好剧不断，继续	GF
看了几年，好剧不断继续支持	GF
看了几年百度，好剧不断，继续支持	GF
看了几年腾讯好剧不断，继续支持	GF
看了两年腾讯，好剧不断，继续支持	GF
注册之时怎么收不到验证码	BR
注册怎么收不到验证码	BR
登记时怎么收不到验证码	BR
登记注册时怎么收不到验证码	BR
注册怎么收不到	BR
爱死但是求花花的对版权啊	ADV
爱死但是求花花的更对改编权啊，山海	ADV
爱死但是求花花的更对发行权啊，山海	ADV
爱死但是的更对版权啊，山海	ADV
但是花花对啊，山海	ADV
很不错希望能在后面对财务报表做进一步提升。比如文本两类可以设置下字数，原本只需要填写很少内容，可很大的空格不好看。财务报表预测能再全面点更好	ADV
很不错希望能后面对进一步提升。比如文本类可以设置下字数，本来只很少，可很大的空格好看。分析能再全面更好	ADV
很不错能后面对报表做进一步提升。比如文本下字数，本来只需要填写很少内容，可很大的空格不。分析能全面点	ADV
很不错希望能在后面对报表做提升。比如文本类可以设置下字数，本来只填写很少，的空格分析能全面点	ADV
很希望能在后面对做进一步提升文本类设置下，需要填写很少内容，可的空格不好看。报表分析能再全面点更好	ADV
很不错希望能在后面对报表做更进一步提升。比如文本类产品可以设下字数，本来只需要填写很少内容，可很大的字符不好看。报表分析能再全面点更好	ADV
很上佳希望能在后面对报表做进一步提升。比如文字类可以设置下字数，本来只需要填写很少内容，可很大的空格不难看。报表分析能再全面点更快	ADV
很不错希望在报表做进一步提升比如文本类可以设置下字数，本来只填写很少内容，可的不。报表再点更好	ADV
很不错希望能在后面对报表做进一步提升。比如文本两类可以设立下字数，本来只需要填写很少内容，可很大的空格不好看。报表预测能再全面点很好	ADV
强制性人脸识别。增加人脸识别选项	ADV
强制性。禁用人脸识别选项	ADV
强制人脸识别。建议增加禁用人脸识别选项	ADV
强制性人脸识别。建议不断增加禁用人脸识别选项	ADV
建议禁用人脸识别选项	ADV
强制性人脸识别。建议增大禁用人脸识别选项	ADV
人脸识别。建议增加禁用人脸识别选项	ADV
自己收藏的表情才150个。每次忍痛删掉其他的	BF
自己收藏的表情不够。才150个。每天忍痛删去其他的	BF
自己收藏的表情不够。才150个。每天忍痛删除其他的	BF
自己藏品的眼神不够。才150个。每次忍痛删掉其他的	BF
收藏的表情不够。150个。每次忍痛删掉其他的	BF
自己收藏的表情不够。才150个。每次的	BF
微信附近人，怎么一直用，	ASK
微信附近的人，怎么一直不能用，污水	ASK
微信附近的人，怎么一直用，垃圾	ASK
QQ附近的人，怎么一直不能用，垃圾	ASK
微信附近怎么一直用垃圾	ASK
微信附近的人，一直用，垃圾	ASK
微信附近的人，怎么一直不能用，废物	ASK
微信的人，一直不能用垃圾	ASK
的怎么用，垃圾	ASK
微信附近的人，怎么不能用，垃圾	ASK
微信附近的，用，垃圾	ASK
微信附近的，怎么不能用垃圾	ASK
微信附近的人，一直不能用，	ASK
微信附近人，怎么一直不能用，垃圾	ASK
微信附近人，怎么一直不能用，	ASK
微信附近的人，一直不能用，垃圾	ASK
微信的人，怎么一直不能，垃圾	ASK
这么好的给去除了。越垃圾	BF
这么好的基本功能给去除了。越更新越垃圾	BF
这么好的功能给去除了。越是更新越是垃圾	BF
这么好的功能给去。更新垃圾	BF
这么好的功能给去除了。越更新越废弃物	BF
看朋友圈的截图退出来时卡顿	BR
看朋友圈视频退出来时卡顿	BR
看的视频来时卡顿	BR
看朋友圈的录像退出来时卡顿	BR
看朋友圈的视频退出卡顿	BR
看朋友圈的音频退出来时卡顿	BR
看朋友圈的视频选择退出来时卡顿	BR
片源不是很多，但是画面很直观	GF
片源不是很多，画面很清晰	GF
片源很多但是画面很	GF
看个几秒的破视频，植入好两段广告，想钱想疯了？mlgb	BF
几分钟的破视频，好几段广告，想钱想疯了？mlgb	BF
看个几分钟的视频，好几段广告，想钱想疯mlgb	BF
看个几分钟的破录像，植入好几段电视广告，想钱想疯了？mlgb	BF
看个的视频植入好几段广告，想想疯了？mlgb	BF
看个几分钟的破录像，植入好两段广告，想钱想疯了？mlgb	BF
超级好有一些歌没有	ADV
超级好，就是有一些歌	ADV
超级好，就是有一些名曲没有	ADV
超级好，就是有一些歌曲没有	ADV
超级好，就是一些歌没有	ADV
超级好，就是有歌没有	ADV
好就是有一些歌	ADV
超级好，就是有一些情歌没有	ADV
超级好，就是有一些新歌没有	ADV
先说一句你连他妈歌也收费了还有，既然收费不能把收费的歌曲和不收费的分开，你爹搜索了下载一个收费下载一个收费的，靠你妈，听不起你们分开可以么	BF
先说一句靠你一家人，连他爸爸汪峰的歌也计费了，还有，既然计费，能不能把计费的经典歌曲和不计费的分开，那样你爹不用搜寻了，订阅一个计费订阅一个计费的，靠你爸爸，我听不起，你们分开可以么	BF
先说一句靠你全家，连妈汪峰的也收费了还有既然能不能收费的歌曲不收费的分开，那样你爹不用搜索了，下载收费一个收费的，你妈我听不起你们分开可以么	BF
先说一句靠你全家，汪峰的歌也收费了，收费能把的和不的分开，那样你爹搜索了，下载收费下载收费的，靠你妈听不起，你们分开可以么	BF
先说一句靠你全家，连他老婆汪峰的一曲也计费了，还有，既然计费，能不能把计费的名曲和不计费的分开，那样你爹不用搜寻了，浏览一个计费浏览一个计费的，靠你老婆，我听不起，你们分开可以么	BF
越做越杂，隐私越来越，支付宝作死	BF
功能越做越杂，越来越不值钱作死	BF
越做越杂，隐私越来越不值钱，支付宝作死	BF
功能越做越杂，隐私越来越不值钱，网银作死	BF
推荐的各种好听，给你各种盛赞	GF
推荐的各种动听，给你各种赞	GF
推荐各种好听，你赞	GF
一直很喜欢要是有更多的发行权就好了	ADV
一直喜欢要是有更多的就好了	ADV
一直很讨厌要是有更多的版权就好了	ADV
一直很喜欢要是有更多的改编权就好了	ADV
一直很喜欢要是有更多的就好了	ADV
很喜欢有更多版权就好	ADV
一直很喜欢要是有更的版权就了	ADV
一直很偏爱要是有更多的版权就好了	ADV
不错，希望多开放些免费中国电信的天翼视讯是竞争对手	ADV
很不错，希望多对外开放些免费的视频。中国电信的天翼多媒体是竞争对手喽	ADV
很不错，期望多开放些免费的视频。中国电信的天翼视讯是竞争者喽	ADV
很不错希望多些免费的视频。的天翼视讯	ADV
很不错，希望多免费的视频中国电信的天翼视讯是竞争对手喽	ADV
很不错，希望多些免费视频。天翼视讯是竞争对手喽	ADV
很很棒，希望多开放些免费的片段。中国电信的天翼视讯是竞争对手喽	ADV
很，希望多开放些免费中国电信的天翼视讯竞争对手	ADV
速度能不能，每次付款都要在那里等支付宝啊原来很方便用的功能现在还要，改版完全没抓到关键点啊，这些基本的东西先做好你去社交不社交的好不好	ADV
启动速度能不能快点，每次超市要在那里支付宝啊，原来很方便用功能还要进去，改版没抓到关键点啊，这些基本的东西你去社交社交的	ADV
启动能快点，每次超市付款都要那里等启动原来很方便的功能现在还要进去，改版完全没抓到关键点啊，这些东西先做好你再去研究什么社交不社交的好不好	ADV
启动飞行速度能不能快点，每次超市付款都要在那里等京东启动啊，原来很方便用的系统现在还要进去找，改版完全没抓到关键点啊，这些基本的东西先搞好你再去研究什么社交不社交的怎么样	ADV
启动速度能不能赶快，每天药店付款都要在那里等支付宝启动啊，原来很方便用的功能现在还要进去找，改版完全没抓到关键点啊，这些基本的东西先做好你再去研究什么SNS不SNS的怎么样	ADV
启动速度能不能快点，每天超市下单都要在那里等支付宝启动啊，原来很方便用的功能现在还要进去找，改版完全没抓到关键点啊，这些基本的东西先搞好你再去研究什么SNS不SNS的怎么样	ADV
启动速度不能快点，每次超市付款都要在支付宝启动啊，原来很方便用的功能现在还要进去找改版完全没抓到关键点啊，这些基本的东西先做好你去研究什么社交不社交的好不好	ADV
启动速度不能快点，超市付款都要在那里支付宝启动啊，原来很方便用的功能还要进去，改版抓到关键点，这些基本的东西做好你再去研究什么社交不社交的好不好	ADV
启动速率能不能赶快，每次超市付款都要在那里等支付宝启动啊，原来很方便用的系统现在还要进去找，改版完全没抓到关键点啊，这些基本的东西先做好你再去深入研究什么社交不社交的怎么样	ADV
启动速率能不能快点，每次门店付款都要在那里等京东启动啊，原来很方便用的基本功能现在还要进去找，改版完全没抓到关键点啊，这些基本的东西先做好你再去研究什么社交不社交的怎么样	ADV
启动速度能不能快点，每次超市付款都在那里等启动啊原来很方便的现在还要进去找，完全没抓关键点啊，这些基本的东西先做好你再去研究什么社交不社交好不好	ADV
挺好的，就是偶尔闪退。这腾讯视频比之前强太多了无论从界面上、还是内容上希望继续努力	BR
挺好的，就是偶尔闪退。这几年搜狗视频比之前强太多了，无论从界面上、还是内容上。期望搜狗继续不懈努力	BR
挺好的，就是偶尔闪退。这几年京东视频比之前强太多了，无论从界面上、还是内容上。期望京东继续不懈努力	BR
挺好的，就是偶尔。这几年之前强太多了，无论从界面上、还是内容。希望腾讯努力	BR
挺好的，就是偶尔闪退。这一两年新浪视频比之前强太多了，无论从界面上、还是内容上。希望新浪继续不懈努力	BR
挺好的，就是偶尔闪退。这几年腾讯片段比之前强太多了，无论从界面上、还是内容上。期望腾讯继续不懈努力	BR
挺好的，就是偶尔闪退。这几年网易视频比之前强太多了，无论从界面上、还是内容上。期望网易继续不懈努力	BR
挺好的，就是偶尔闪退。这数十年京东视频比之前强太多了，无论从界面上、还是内容上。期望京东继续努力	BR
挺好的就是偶尔。这几年腾讯视频比之前强太多，无论从界面上、还是内容。希望腾讯继续努力	BR
挺好的，就是偶尔闪退。这几年视频比强太多了，无论从界面上、内容上。希望腾讯努力	BR
升级之后不能在用QQ号码提出申请QQ，亲人朋友和客户都在朋友圈，每次发条QQ还得想想有没有不适于那组看的内容，太烦了。希望可以有两个手机号，不要都是用手机号来提出申请	ADV
升级不能用码申请，家人朋友和客户在朋友圈每次发条微信还得想想有没有不适合那组的内容，太烦了。希望可以有两个，不要都是手机号来申请	ADV
升级之后不能在用码申请微信，家人和客户都在朋友圈，每次发条微信得想想有没有不适合那组看的内容太烦了。希望可以有两个账号，不要都是手机号申请	ADV
升级之后不能在用手机号码申请QQ，家人朋友和客户都在朋友圈，每次发条QQ还得想想有没有不适合那组看的内容，太烦了。希望可以有七个帐号，不要都是用电话号码来申请	ADV
升级之后不能在用手机号码申报微信，母亲朋友和客户都在朋友圈，每次发条微信还得想想有无不适合那组看的内容，太烦了。希望可以有九个账号，不要都是用手机号来申报	ADV
升级不能QQ号码申请微信家人朋友和客户朋友圈，每次发条微信得想想有没有不适合那组看的内容，太烦了。可以有两个，不要都是用手机号来申请	ADV
升级之后不能在用手机号码申请微信，母亲女朋友和客户都在朋友圈，每次发条微信还得想想有没有不合适那组看的内容，太烦了。希望可以有两个手机号，不要都是用手机号来申请	ADV
升级之后不能在用QQ号码申请QQ，亲人朋友和顾客都在朋友圈，每天发条QQ还得想想有没有不适宜那组看的内容，太烦了。希望可以有两个账号，不要都是用手机号来申请	ADV
升级之后不能在用QQ号码注册QQ，家人同学和客户都在朋友圈，每次发条QQ还得想想有没有不合适那组看的内容，太烦了。期望可以有两个账号，不要都是用手机号来注册	ADV
更新完之后没有提示音了搞什么飞机	BR
更新完之后提示音。搞什么	BR
更新完之后没有提示音了。搞什么直升机	BR
更新完之后没有提示音了。搞什么运输机	BR
更新完之后提示音了。搞什么	BR
更新完之后提示音了。搞什么飞机	BR
更新完之后没有提示音了。搞什么航机	BR
小时候老师大家写想象作文，天马行空的想法在当今得到了验证，可以打电话的手表，出门不用带钞票就可以买，薄如板的，妈妈减轻负担的洗碗机，全自动洗衣机	GF
童年时代老师让大家写下想象作文，天马行空的想法在当今得到了验证，可以打电话的手表，出门没法带纸币就可以买东西，薄如板的电视机，帮妈妈减轻负担的洗碗机，全自动洗衣机	GF
小时候老师让大家想象作文天马行空想法在当今得到了验证，可以的手表出门不用带钞票就可以，薄如板的电视机，帮妈妈减轻负担的洗碗机全自动洗衣机	GF
小时候老师让大家想象作文，天马行空的想法当今得到了验证，可以打电话的，出门不用带钞票就可以买东西，薄如板的电视机，妈妈减轻负担的洗碗机，全自动洗衣机	GF
牵涉到钱的东西能不能麻烦你们的子系统和功能做的好一些。花呗已经偿还，钱包账单都出来了，可是花呗虽然提示未偿还，那我的钱哪儿去了？你们连个能联系的人也没有	BR
涉及东西能不能麻烦你们的系统和功能做的好花呗已经，银行卡账单都出来了可是花依然提示未还款那我的钱哪儿？你们连个能联系的人也	BR
钱的东西能麻烦你们系统和功能做的好一些。呗已经，银行卡都出来了，可是花呗依然提示未，那我的钱哪儿去？你们连个能的没有	BR
涉及银子的东西能不能麻烦你们的系统和特性做的好一些。花呗已经借款人，信用卡账单都出来了，可是花呗依然提示并未借款人，那我的银子哪儿去了？你们连个能联系的人也没有	BR
涉及钱能不能麻烦你们的系统功能做的好一些花呗已经还款，银行卡都出来了，可是花呗依然提示未还款，那的哪儿了？你们能联系的人也没有	BR
涉及银子的东西能不能麻烦你们的信息系统和机能做的好一些。花呗已经借款，银行卡账单都出来了，可是花呗仍然提示未借款，那我的银子哪儿去了？你们连个能联系的人也没有	BR
涉及钱的能不能麻烦系统和功能做的好一些。花已经还款，银行卡账单都出来可是花呗依然提示未还款，那我的钱哪儿去了你们连个能联系的人也没有	BR
涉及钱的东西能不能你们的系统和做的好花呗已经还款，都出来了，可是花呗依然提示未还款，那我的钱哪儿去了？你们连个能联系的人也没有	BR
第一次使用方便快捷的选择希望使用了	GF
第四次使用了，简便，很不错的选择，希望更多人使用了	GF
第二次使用了，方便快捷，很上佳的选择，希望更多人使用了	GF
第二次使用了，方便快捷，很不错的选择，期望更多人使用了	GF
第一次使用了，方便快捷，不错的，希望	GF
网易云音乐好几年了，早早的充会员，因为版权原因不全也就算了，这听歌识曲功能太弱了，一首经典的英文歌从开头到结尾都不能识别出来，显示两首完全不一样的歌曲。不会再充值啦	BF
搜狗云流行音乐用了好几年了，早早的充了会员，因为版权原因流行歌曲不全也就算了，这听歌识曲功能也太弱了吧，一首经典之作的英文歌曲从开头到结尾都不能识别出来，显示了两首风格完全不一样的流行歌曲。明年不会再转账会员啦	BF
搜狗云音乐用了好几年了，早早的充了会员，因为著作权原因歌曲不全也就算了，这听歌识曲功能也太弱了吧，几首经典之作的英文歌曲从开头到结尾都不能鉴别出来，显示了两首风格完全不一样的歌曲。明年不会再充值会员啦	BF
网易和云音乐用了好多年了，早早的充了会员，因为改编权原因歌曲不全也就算了，这听歌识曲功能也太弱了吧，一首经典的英文歌从开头到结尾都不能辨识出来，显示了四首音乐风格完全不一样的歌曲。明年不会再充值会员啦	BF
网易云用了了，的了因为原因不全就算了，这识曲功能太弱了吧，一首经典开头结尾识别出来，显示了两首风格完全不一样的歌曲。明年再充值会员啦	BF
火死了，笔记本电脑宝令都找不着了，让我怎么付款啊	ASK
了，手机宝令都了，让我怎么付款	ASK
火死了，手机宝令都找不着了，让我怎么退款啊	ASK
火死，手机宝令都了，我怎么付款啊	ASK
火死了，手机宝令都找不着了，让我怎么结账啊	ASK
火死了，新手机宝令都找不着了，让我怎么付款啊	ASK
火死了，手机都找不着了，让我付款啊	ASK
了手机宝令都找不着，让怎么啊	ASK
火死了宝令都找不着，让怎么付款	ASK
火死了，手机宝令找不着了，怎么啊	ASK
火死了，手机宝令都找不着了，让我怎么收款啊	ASK
火死了，手机宝令找不着了，让我怎么付款啊	ASK
火死了，智能手机宝令都找不着了，让我怎么付款啊	ASK
火死了，手机宝令都找不着了，让怎么啊	ASK
火死了手机宝令都找不着了，我怎么付款啊	ASK
火死了，都找不着了，让我怎么付款啊	ASK
火死了，iPhone4宝令都找不着了，让我怎么付款啊	ASK
火死了，手机宝令找不着了让我怎么付款啊	ASK
火死了，手机宝令都找不着了，我付款啊	ASK
火死了，手机找不着了，让怎么付款啊	ASK
了，手机宝令找不着了，让我怎么付款啊	ASK
火死了，手机宝令都找不着了，让我怎么下单啊	ASK
火死了，手机宝令都找不着，让怎么付款啊	ASK
火死了手机宝令找不着了，让怎么付款啊	ASK
火死了，笔记本宝令都找不着了，让我怎么付款啊	ASK
火死了，手机宝令都找不着了，让我怎么付款	ASK
D2上一版本还支持的，升级不支持了	BR
D2上一标准版还支持的，升级后不支持了	BR
D2上一版还支持的，升级后不支持了	BR
D2上一版本还支持，后不支持了	BR
D2上版本还的，后不支持了	BR
两周了怎么还没搞定什么破技术	BF
一周了怎么还没搞定什么破控制技术	BF
一周了怎么还搞定什么技术	BF
三个月了怎么还没搞定什么破技术	BF
最近有钉钉红包，然后强制分享，强制应邀别人登陆注册。而且在软件外部给差评还信息出错，我就呵呵了	BF
最近有钉钉，然后分享，强制邀请别人。而且在软件内部给差评还出错，我就呵呵了	BF
最近有钉钉红包，然后强制性分享，强制性邀请别人登陆登记。而且在开发工具内部给差评还数据出错，我就呵呵了	BF
最近有钉钉红包，然后强制分享，强制邀请别人登陆登记注册。而且在开发工具外部给差评还数据出错，我就呵呵了	BF
最近有红包，然后强制，强制别人登陆注册。而且在软件给差评数据出错，我就了	BF
有钉钉红包，然后强制分享强制邀请别人登陆。而且在软件内部给还数据，我就呵呵了	BF
凭什么没有勿扰模式，完全没有隐私	BF
凭什么没有勿扰，完全隐私	BF
凭什么iOS没有勿扰模式，完全没有隐私权	BF
凭什么iOS没有勿扰商业模式，完全没有隐私	BF
垃圾软件没有手势，不能隐藏余额宝金额，谁都能点开看的到，想骂人，根本就掩耳盗铃，有个鬼用	BF
垃圾软件，没有手势密钥做屏障，完全不能暗藏余额宝数额，谁都能点开看的到，好想骂人，根本就掩耳盗铃，有个鬼用	BF
，没有手势密码做完全不能隐藏宝，谁开看的到，好想骂人，根本就，有个鬼用	BF
废弃物硬件，没有手势密码做屏障，完全不能隐藏余额宝额度，谁都能点开看的到，好想骂人，根本就掩耳盗铃，有个鬼用	BF
就是为了能在两倍速看片结果你给我自动识别视频跟普通投屏似的什么airplay，就是手机什么样就给我什么样腾讯花大力气这东西真是吃力不讨好，非常愚蠢愚蠢至极	BR
我用airplay就是为了能在电视上五倍速看片，结果你给我自动识别音频跟普通投屏似的，什么叫airplay，就是我智能手机什么样电视就给我什么样，搜狗花大力气改这东西真是吃力不讨好，非常无耻。无耻至极	BR
我用airplay就是为了能在有线电视上七倍速看片，结果你给我自动识别视频跟普通投屏似的，什么叫airplay，就是我手机什么样有线电视就给我什么样，腾讯花大工夫改这东西真是吃力不讨好，非常可笑。可笑极其	BR
airplay就是为了能在电视两倍速，结果你给我自动识别跟投屏似的什么叫airplay，就是我电视就给什么样，腾讯力气这东西真是吃力不讨好，非常愚蠢至极	BR
我用airplay就是为了能在电视上两倍速看片，结果你给我自动识别视频跟普通投屏似的，什么叫airplay，就是我智能手机什么样电视就给我什么样，京东花大工夫改这东西真是吃力不讨好，非常可耻。可耻无比	BR
我用airplay就是为了能在电视上五倍速看片，结果你给我自动识别音频跟普通投屏似的，什么叫airplay，就是我新手机什么样电视就给我什么样，UC花大工夫改这东西真是吃力不讨好，非常愚蠢。愚蠢至极	BR
airplay就是为了能电视上两倍速，结果你给我自动识别视频跟普通投屏似的，什么叫airplay，就是我手机什么样就给我，腾讯力气改这东西真是吃力不讨好，非常愚蠢。愚蠢至极	BR
如果不开会员能下载MV就好了	ADV
如果不开会员下载mv就了	ADV
如果不开会员能iTunesmv就好了	ADV
如果会员能下载mv就好了	ADV
如果不开会员能上传mv就好了	ADV
如果不会员能就好了	ADV
不开会员能下载mv就好了	ADV
一个个黄昏的悲伤，开心是惬意的旋律，还有陪伴我运动时的“燃”读书的安静，所有的时间的陪伴，不离不弃	GF
一个个夜晚的悲伤，高兴是惬意的旋律，还有陪伴我运动时的“燃”读书的安静，所有的时间的陪伴，不离不弃	GF
无数个夜晚的悲伤，开心是愉悦的曲子，还有陪伴我运动时候的“燃”教书的安静，所有的时间的陪伴，不离不弃	GF
无数个夜晚开心是愉悦的旋律，我运动时的“燃”读书的安静，所有的时间的陪伴不弃	GF
无数个夜晚的悲伤是的，还有陪伴我运动的“燃”读书的安静，所有的不弃	GF
无数个夜晚的悲伤，开心愉悦的旋律，还有我运动时的“燃”读书的安静，所有的陪伴，不离	GF
怎么会有这么好用的播放器，如果手机里边只有一个应用软件，一定会是网易云音乐	GF
有这么好用的播放器如果手机里只有一个软件，一定会是网易云音乐	GF
怎么会有这么好用的播放器，如果手机里一个软件，一定会网易音乐	GF
怎么会有这么好用的播放机，如果手机里边只有一个软件，一定会是网易云音乐	GF
怎么会有这么好用的随身听，如果手机里只有一个软件，一定会是腾讯云音乐	GF
作为一款笔记本电脑办公软件，非常方便实用	GF
作为一款手机办公，方便实用	GF
作为一款手机办公软体，非常方便实用	GF
后像以往一样一点清除缓存，选择性清理聊天记录的确让我一时难以。评论，用户都了问题。聊天记录有时仍需保留，但缓存的却清缓存一天不清可以，但积久不清就是个了。微信一直很好，此次一星这个可大可小问题。希望早日恢复自动清缓功能，我们一个能够清理“”的	ADV
更新后不能像以往一样一点手动清理缓存，就可以选择性清理聊天记录，的确让我一时不易接受。下载文章，原来大多使用者都提出了这个问题。聊天记录有些有时仍需保留，但缓存的却不可不清。缓存一天不清可以，但积久不清就是个问题了。微信一直很好用，此次给少一星是因为出现了这个可大可小的问题。期望能尽早恢复手动清缓功能，给我们一个能够另行清理“积压”的空间	ADV
更新后不能像以往一样一点手动拔除缓存，就可以特异性清理聊天记录，的确让我一时难以接受。下载评论，原来大多用户都提出了这个问题。聊天记录有些有时仍需保留，但缓存的却不可不清。缓存一天不清可以，但积久不清就是个问题了。QQ一直很好用，此次给少一星原因在于出现了这个可大可小的问题。希望能尽早恢复正常手动清缓机能，给我们一个能够自行清理“积压”的空间	ADV
更新后不能像以往一样一点自动拔除寄存器，只能选择性清理聊天记录，的确让我一时极难接受。下载评论，原来大多用户都明确提出了这个问题。聊天记录有些有时仍需以保留，但寄存器的却不可不清。寄存器一天不清可以，但积久不清就是个问题了。QQ一直很好用，此次给少一星是因为出现了这个可大可小的问题。期望能早日恢复正常自动清缓功能，给我们一个能够另行清理“积压”的空间	ADV
更新后不能像以往一样一点清除缓存，清理，的确我一时难以接受。浏览，原来大多用户都了这个问题。聊天记录有些有时仍需保留但缓存却清。不清可以，但积久不清就是个问题了微信一直很好用，此次给少一星是因为了这个可大可小的问题。能早日恢复自动功能，给我们一个能够自行清理“积压空间	ADV
后不能像以往一样一点自动缓存，只能选择性清理聊天记录，一时难以接受。浏览评论，原来用户都提出这个问题。聊天记录有些有时需保留，但的却不可不清缓存一天不清可以，但积久就是个问题了微信很好用，此次少一星是因为出现了这个可大可小的能早日恢复自动清缓功能，给我们一个能够自行清理“积压”的	ADV
更新后不能像以往一样一点自动拔除缓存，就可以特异性清理聊天记录，的确让我一时难以接受。下载评论，原来大多用户都明确提出了这个问题。聊天记录有些有时仍需保留，但缓存的却不可不清。缓存一天不清可以，但积久不清就是个问题了。QQ一直较好用，此次给少一星是因为出现了这个可大可小的问题。期望能尽早恢复自动清缓机能，给我们一个能够自行清理“积压”的空间	ADV
我微信有信息预约或定时发送”功能，这样可以在的编写好一条信息并设定好发送时间，特别在开车时，我觉得这个功能非常实用，会得到许多人的认可	ADV
我期望微信能有“信息预订或定时发送给”系统，这样我可以在有空的编写好一条信息，并设定好定时发送给时间，特别在开车时，我觉得这个系统非常实用，会得到许多人的认同	ADV
我希望微信能有“信息或定时发送，这样我可以在有空的好一条信息，并设定好定时发送时间，在开车时，我觉得这个功能非常会得到许多人的	ADV
我希望微信能有“信息预约或定时发送给”功能，这样我可以在有空的编写好两条信息，并设定好定时发送给时间，尤其在上车时，我觉得这个功能非常实用，会得到许多人的认同	ADV
我微信能有“信息或定时发送”功能，我可以在有空的编写好，并定时发送时间，特别在开车时，觉得这个功能非常实用，许多人的认可	ADV
我希望QQ能有“数据预订或定时发送”功能，这样我可以在有空的编纂好一条数据，并设定好定时发送时间，特别在开车时候，我觉得这个功能非常实用，会得到许多人的认可	ADV
我希望微信能有“预约或定时发送功能，这样我在有空编写好信息，并定时发送时间，开车时觉得这个非常实用，会许多人的	ADV
希望微信能有信息预约或定时发送功能，这样可以在有空的编写好一条信息，设定好定时发送时间，在开车时，觉得功能非常实用，会许多人的认可	ADV
钉钉的办公改变了我们母公司传统的方式，iPhone4上随时可以处理很多事情，专注模式很赞，能够让我分类管理我的沟通情形	GF
钉钉的办公改变了公司的，上可以处理很多事情，专注模式很赞，让分类管理我的沟通情况	GF
钉钉的办公改变了我们公司现代的方法，手机上随时可以处理很多事情，专注方法很赞，能够让我分类管理我的沟通情况	GF
钉钉的办公改变了公司传统的方式手机随时可以很多事情专注模式，能够让我分类管理我的沟通	GF
钉钉的办公改变我们公司传统的方式，手机上随时处理很多事情，专注模式很赞，能够让我分类管理我沟通情况	GF
既然天天喊着让给打分，今天就评一次，抱歉1星，虽然往后又续了数年会员，但是，你们这个多倍速或许垃圾，我很挑剔，如果多倍速没有声音，实在是无法让我给你赞誉，火速更新吧，希望把技术做成熟再拿出来炫耀	BF
既然天天喊着让给评分，今天就评一次，抱歉1星，虽然往后又续了一个月会员，但是，你们这个多倍速难道污水，我很挑剔，如果多倍速没有声音，确实是难以让我给你好评，火速更新吧，期望把技术做成熟再拿出来炫耀	BF
既然天天喊着让给评分今天就评一次，1星，虽然往后又续了两年会员，但是你们这个多倍速真的垃圾，我很挑剔如果多倍速，实在是难以让我给你好评火速更新吧希望把技术做成熟出来	BF
既然天天喊着让给，今天一次，对不起1星，虽然往后又续了两年会员，，你们这个多倍速真的，我很挑剔如果多声音，实在是难以让我给好评，火速更新吧，希望把做成熟再拿炫耀	BF
驱动程序下来的视频看不了，要联网	BR
缓存下来视频看，要联网	BR
磁盘下来的视频看不了，要联网	BR
缓存下来的片段看不了，要联网	BR
缓存下来的视频看，要联网	BR
缓存下来的不了，要联网	BR
下来的视频看不了，要联网	BR
缓存下来的录像看不了，要联网	BR
多年，第一个打差评，，迟了就几分钟就扣钱，说公司制度不行也是事。，你发明就给了公司，理由，不是人都能正常不迟到的，迟到扣钱。我们挣点钱容易。你们自己想想，天天签到	BF
，第一个打的，签到，迟就就扣钱，说自己制度不行也是个事但是，你发明就给了公司，扣钱理由，不是每个人都能正常一天不迟到，就。我们点钱吗。你们自己想想，天天签到	BF
这么余年，第一个打差评的，一个签到，迟了就几分钟就扣钱，说自己子公司体制没用，也是个事情。但是，你发明签到就给了子公司，扣钱理据，不是每个人都能正常一天不迟到的，迟到就扣钱。我们赚到点钱容易吗。你们自己想想，天天签到	BF
这么多年，第四个打差评的，一个签到，迟了就几秒钟就扣钱，说自己公司制度建设没用，也是个大事。但是，你发明者签到就给了公司，扣钱理由，不是每个人都能正常一天不迟到的，迟到就扣钱。我们赚点钱容易吗。你们自己想想，天天签到	BF
这么多年，打差评的一个签到，了就几分钟就扣钱，说自己公司制度不行，也是个事。，你发明就了公司，扣钱理由，不是人能正常一天不的迟到就我们挣点钱容易吗。你们自己想想，天天签到	BF
这么几十年，第一个打差评的，一个签到，迟了就两分钟就扣钱，说自己公司体制不行，也是个小事。但是，你发明者签到就给了公司，扣钱理据，不是每个人都能正常一天不迟到的，迟到就扣钱。我们赚点钱容易吗。你们自己想想，天天签到	BF
个人感觉优于腾讯和爱奇艺	GF
个人感觉优于土豆网和爱奇艺	GF
个人感觉高于优酷和爱奇艺	GF
用网易云，觉得着很舒服	GF
习惯了用网易云音乐，用着很舒服	GF
习惯了用网易和云音乐，觉得用着很舒服	GF
习惯了用网易云音乐，觉得用着很难受	GF
的APP是在一起比丑吗	BF
BATJ的APP是在一起比丑吗	BF
的APP在一起比丑吗	BF
BATAPP在一起比丑	BF
很心碎啊，很多软件包自动更新了，这个QQ怎么调都不能升级	BF
很心碎啊，很多硬件自动更新了，这个QQ怎么调都不能升级	BF
很心痛啊，很多软体自动更新了，这个微信怎么调都不能升级	BF
很啊，很多了，微信不能升级	BF
很心碎啊，很多自动更新了，这个微信怎么调都升级	BF
心碎啊很多自动更新了，这个微信怎么调都不能	BF
真垃圾，看个视频开始广告130秒，到中间了是广告90秒，什么时候腾讯变成这样，变着法的让开会员真垃圾，不如爱奇艺广告才45秒	BF
呀污水，看个录像开始电视广告130秒，到中间了又是电视广告90秒，什么时候UC录像变成这样了，这是变着法的让开会员啊，呀污水，还不如爱奇艺呢，电视广告才45秒	BF
真垃圾，视频开始广告130秒，到了又是广告秒，什么时候腾讯变成这样变着法让开会员，真垃圾，不如爱奇艺呢广告45秒	BF
真垃圾视频开始广告130秒，到中间了又是广告90秒，什么腾讯视频变成这样了这是的让开会员啊，真垃圾还不如爱奇艺呢，广告才秒	BF
真的垃圾，看个截图开始商业广告130秒钟，到中间了又是商业广告90秒钟，什么时候网易截图变成这样了，这是变着法的让开会员啊，真的垃圾，还不如爱奇艺呢，商业广告才45秒钟	BF
喜欢这个朋友介绍的	GF
很喜爱这个软件，朋友介绍的	GF
这个软件朋友介绍的	GF
好多歌只有翻唱版没有原唱忍	BF
歌只有翻唱没有原唱不能忍啊	BF
好多歌曲只有翻唱版没有原唱不能忍啊	BF
好多歌只有翻唱版没有原唱者不能忍啊	BF
好多歌只有填词版没有原唱不能忍啊	BF
一直用腾讯片段，新片跟进很快	GF
一直用腾讯，新片很快	GF
一直用腾讯视频，新片跟进迅速	GF
一直用腾讯，新片跟进很快	GF
京东注册登记的邮箱是以前的手机号码，更新了京东后登陆要发验证码到以前的手机号码上，现在京东登陆不了了	BR
支付宝注册帐号是以前的，更新了后登陆要发验证码到的手机号码上登陆不了了	BR
网银注册登记的用户名是以前的手机号码，更新了网银后登陆要发验证码到以前的手机号码上，现在网银登陆不了了	BR
帐号是以前的手机号码，更新了支付宝后要发验证码到以前手机号码，现在支付宝不了了	BR
注册帐号是的手机号码，支付宝后登陆要发到以前的手机号码，支付宝登陆不了了	BR
京东登记注册的页面是以前的手机号码，更新了京东后登陆要发验证码到以前的手机号码上，现在京东登陆不了了	BR
银联注册登记的帐户是以前的手机号码，更新了银联后登陆要发验证码到以前的手机号码上，现在银联登陆不了了	BR
支付宝注册的帐号的手机号码更新了后要发验证码到以前的上，现在支付宝登陆了	BR
PayPal登记的账号是以前的手机号码，更新了PayPal后登陆要发验证码到以前的手机号码上，现在PayPal登陆不了了	BR
支付宝注册帐号以前的，更新了支付宝后要发到以前的，现在支付宝不了了	BR
不能免费通话从不用了，越做越差	BF
不能免费通话不想用了越做越差	BF
不能免费通话不想用了，越做越高	BF
不能免费通话不想，越做越	BF
通话不想用了，越做越差	BF
此更新，实用了，不但快递能及时跟踪，每一笔付款和都能看的清清楚楚，不错，绝对颗星，支付宝就是比其他方式灵活，但是有一个不实用就是充值优惠幅度没有软件	GF
此更新，非常实用了，不但快递能及时跟踪，连每一笔收款和收款都能看的清清楚楚，不错，绝对5颗星，支付宝收款就是比其他方法较快灵活，但是有一个不实用就是手机充值优惠活动降幅没有淘宝软件实惠	GF
更新，非常实用了，不但能及时跟踪，连一笔付款和收款都能看的清清楚楚，不错，5颗星，支付宝付款比其他方式灵活，但是有一个就是手机充值优惠幅度没有软件	GF
此更新，非常实用了，不但快递能及时追踪，连每一笔付款和收款都能看的清清楚楚，不错，绝对5颗星，支付宝付款就是比其他模式加速灵活，但是有一个不实用就是手机充值卡优惠幅度没有淘宝开发工具实惠	GF
很多微博上钟爱的po主推荐的歌都不容易找，现在网易和云音乐很方便啊	GF
微博上喜欢的po主推荐的都不容易找现在网易音乐很	GF
很多微博喜欢主推荐的歌都不现在网易云很方便啊	GF
很多微博上喜爱的po主推荐的歌都不容易找，现在网易和云音乐很方便啊	GF
很多微博上喜欢的po主推荐的歌都不容易找，现在搜狗云电子音乐很方便啊	GF
如果不是田馥甄的改编权回老家了我怕是仍然用着虾米	GF
田馥甄的回来了我怕仍然用着虾米	GF
如果不是田馥甄的改编权过来了我怕是仍然用着虾米	GF
如果不是田馥甄的版权回来了怕是仍然用虾米	GF
好像是有人蓄意打低分呢，新浪云这么好用，竟然被人蓄意打低分，不能忍，里面的评论较好哦，用了很久啦	GF
好像是有人恶意打低分呢，网易云这么，被人恶意打低分，，里面的评论很好哦，用了很久啦	GF
好像是有人恶意打高分呢，网易和云这么好用，竟然被人恶意打高分，不能忍，里面的评论极好哦，用了很久啦	GF
仿佛是有人蓄意打低分呢，网易云这么好用，竟然被人蓄意打低分，不能忍，里面的评论更好哦，用了很久啦	GF
好像有人恶意打低分，云这么好用，打低分，不能忍，的评论很好哦，了很啦	GF
有了支付宝生活啊方便。真的很好	GF
了支付宝生活真方便。真的很好	GF
有了支付宝生活真方便。或许很好	GF
有了京东生活真方便。真的很好	GF
节目都是好节目，但是这个广告有点过分吧切个还需要一遍么？切也需要再看一遍	BF
新闻节目都是好新闻节目，但是这个商业广告有点过分吧？切个网络还需要再放一遍么？切对比度也需要再看一遍么	BF
节目都是好节目，但是这个商业广告有点过份吧？切个网络平台还需要再放一遍么？切清晰度也需要再看一遍么	BF
节目都是好节目但是这个广告过分吧？切个网络还需要再放一遍么切清晰度也需要看一遍么	BF
就是功能太多，都知道是干的	BF
就是系统太多，都不知道是干啥的	BF
就是功能太多，都不知道干啥的	BF
就是机能太多，都不知道是干啥的	BF
定位从来不准，有问题找客服服务态度较差	BF
定位从来不准，有问题找服务态度极差	BF
定位从来不准，问题客服服务态度	BF
定位从来不得，有问题找客服服务态度极差	BF
从来不准，问题找客服服务态度	BF
定位从来不准，有问题找客服人员服务态度极差	BF
垃圾你爸卖。自动扣费老子从来都不知道还叫老子开一个会员出六次钱	BF
垃圾你妈卖。手动扣费老子从来都不知道还叫老子开一个会员出九次钱	BF
垃圾你妈卖。自动老子都不知道还叫老子开一个会员出两次	BF
垃圾你妈买。自动扣费道德经从来都不知道还叫道德经开一个会员出两次钱	BF
夜间模式置顶群的底一调置顶会话差异过大，有点突兀，调一调色	ADV
希望能把日间商业模式置顶群的底用色一调，与非置顶会话差异过大，有点突兀，可以再往深地调一调色	ADV
期望能把夜间商业模式置顶群的底暖色调一调，与非置顶会话差异过大，有点突兀，可以再往深地调一调色	ADV
期望能把日间商业模式置顶群的底色调一调，与非置顶会话差异过大，有点突兀，可以再往深地调一调色	ADV
希望把夜间模式的色调一调与非置顶会差异过大，有点突兀可以再往深地调一	ADV
希望能把夜间置顶群的色调一调，置顶话差异过大，有点再往深地调一调色	ADV
希望把夜间模式置顶群的底色调一调与非会话过大，有点突兀，可以再往深地调一	ADV
期望能把白天模式置顶群的底色调一调，与非置顶会话差别过大，有点突兀，可以再往深地调一调色	ADV
期望能把日间模式置顶群的底色调一调，与非置顶会话偏差过大，有点突兀，可以再往深地调一调色	ADV
希望能把夜间置顶的底色调一调，与非置顶会差异，有点，可以再往调一调色	ADV
能把夜间模式置顶群的底一调，与非置顶话差异，有点突兀，可以再往深地调一调色	ADV
M5不过会出现追的剧没了，看不了啊。希望赶daw快修缮，赞个	ADV
M6不过剧没了，看不了啊。希望赶daw快修复，赞个	ADV
M6不过会出现追的大戏没了，看不了啊。期望赶daw快修复，赞个	ADV
M6不过会出现的剧没了看不了啊。赶daw快修复，赞个	ADV
M5不过会出现追的剧没了，看不了啊。希望赶daw快加固，赞个	ADV
M6不过追没，看不了啊希望赶daw快修复，赞个	ADV
M6不过会出现追的剧没了，看不了啊。赶daw快，赞个	ADV
我更新了最新版本后运行内存，起码800，mb1个G的占用内存，真	BF
我更新了最新版本后内存增加起码800，mb/1个G的占用内存，真垃圾	BF
我更新了最新版本后运行内存增加，起码800，mb1个G的占用内存，垃圾	BF
我更新了最新版本后运行存储器增加，最起码800，mb/1个G的占用存储器，真垃圾	BF
我只想说一句:你们的软件很好，但是可不可以把“不能分享超过5分钟的截图”换为10分钟	ADV
我只想:你们的软件很好，可不可以把“分享超过5分钟的”改成10分钟	ADV
我只想说一句:你们的软件很好，但是把“不能5分钟的视频”改成10	ADV
我只想说一句:你们的软体很好，但是可不可以把“不能分享超过5分钟的视频”换成10分钟	ADV
只想说一句:你们的软件，但是可不可以把“不能分享超过分钟的视频”改成10分钟	ADV
我只想:你们的软件很好，但是可不可以把“不能分享超过分钟的视频”改成10分钟	ADV
我只想说一句:你们的软件较好，但是可不可以把“不能分享超过5分钟的视频”改为10分钟	ADV
我只想说一句:你们的开发工具很好，但是可不可以把“不能分享超过5一分钟的视频”改成10一分钟	ADV
比以前好太多了很这个样子，很人性化	GF
比以前好太多了，很喜欢现在这个模样的，很人性化	GF
比以前好太多了，很喜欢现在这个样子的，很	GF
比以前好太多了，很喜欢现在这个的，很	GF
工作硬件，功能强大。就是特别耗电，希望升级的时候能加上大区电方式，工作群调变为震动，大半天也给震没了。不提示又收不到工作信息。不能及时答复，会对工作有冲击。在室外最怕没电，不是每个人都是坐办公室不动的，希望可以开通大区电方式	BF
软件，。耗电升级的时候能加上省电模式，工作成震动，半天也震了。不提示又收不到工作信息。不能及时回复对工作有。在最怕没电，不是每个人都是坐办公室不动的希望可以省电	BF
工作软件，功能强大。就是尤其耗电，期望升级的时候能加上大区电商业模式，工作群调成震动，半天也给震没了。不提示又收不到工作信息。不能及时答复，会对工作有影响。在户外最怕没电，不是每个人都是坐办公室不动的，期望可以开业大区电商业模式	BF
工作软件，功能强大就是耗电，希望的能加上省电模式，工作群调成震动，半天也给震没了。不提示又收不到工作信息。不能，会对工作有影响。在室外最怕没电，不是每个人都是坐办公室的电模式	BF
工作开发工具，功能强大。就是特别发热量，期望升级的时候能加上大区电商业模式，工作群调成震动，半天也给震没了。不提示又收不到工作信息。不能及时答复，会对工作有影响。在室外最怕没电，不是每个人都是坐办公室不动的，期望可以开业大区电商业模式	BF
工作软件功能强大。就是希望升级的能加上省电模式，工作群调成震动，半天也给震没了。提示又收不到信息。不能及时回复，会对工作有影响。在室外最怕不是人都是办公室不动的，希望可以开通省模式	BF
每个月自动续费难关了，也不是什么大钱问题就是说好了离线视频等上了飞机后我怎么打开网络？这样的视频有什么意思	BF
每个同月自动续费难关就算了，也不是什么大钱，问题就是说好了离线片段等上了航机后我怎么去打开网路？这样的离线片段有什么意思	BF
每个自动续费难关就算了不是什么大钱，就是说离线视频等上了飞机后我怎么去网络？这样的离线视频什么意思	BF
每个月自动难关就算了也不是什么问题好了离线视频等上了飞机我怎么去打开网络这样离线视频什么	BF
每个同月手动续费难关就算了，也不是什么大钱，问题就是说好了离线录像等上了滑翔机后我怎么去打开网络？这样的离线录像有什么意思	BF
是哪个屎一样的程序提议迁移到一台手机”这个屎一样的建议？还不能关闭屏幕，还必须前台运行，最的是实际的时间非常久，迁移的聊天记录大小远远超出显示的大小。我不是程序猿，我不懂那些技术上的事，但我是用户，我知道这个体验就是踩到屎的感觉	BF
是哪个屎一样程序猿提议“迁移聊天记录另外一台手机”这个屎建议？不能关闭屏幕还必须前台，最厌恶的是实际等待的时间非常久迁移的大小远远超出显示的大小我程序我不懂那些技术上的事，但我用户，我这个体验就是屎一样的感觉	BF
是哪个屎一样猿“迁移聊天记录另外一台”这个屎一样的建议？还不能关闭屏幕，还必须前台运行，厌恶的是实际等待的时间非常久迁移的聊天记录大小远远超出显示大小。不是猿，我不懂那些技术上的事但是用户，我体验就是踩到屎一样感觉	BF
是哪个屎一样的处理程序猿提议“迁移聊天记录到另外一台手机”这个屎一样的建议？还不能关闭触摸屏，还必须前台运转，最痛恨的是实际耐心等待的时间非常久，迁移的聊天记录大小远远超出表明的大小。我不是处理程序猿，我不懂那些技术上的大事，但我是用户，我知道这个体验就是掉入屎一样的感觉	BF
我这种网易云放dock栏的一点儿都不想，等下个版本改回来在更新	BF
我这种把腾讯云放dock栏的真是一点儿都不想更新，等下个标准版改回来在更新	BF
我这种把网易云放栏的真是一点儿都不想，等在更新	BF
我这种把网易云放dock栏的一点儿都不想更新，等下个版本改回来在更新	BF
好评，大幅提升效率，管理更方便	GF
好评，持续提升效率，管理更方便	GF
好评，降低效率，管理更方便	GF
，提升效率，管理更方便	GF
花呗最好自定义一下不然9号还款，十几号发工资，还款日正好是钱花的，每次还款很尴尬	ADV
花呗还款日最好自定义，不然号还款，然而十几号才，还款日正好是钱花光光的，很尴尬	ADV
花呗还款日最好能自定义一下不然9号还款，然而才发工资，还款日正好是钱花的，每次还款很	ADV
花呗还款日最好能自定义一下，不然9号偿还，然而十几号才发工资，还款日刚好是钱花光光的时候，每天偿还很尴尬	ADV
花呗还款日最好能配置文件一下，不然9号还款，然而十几号才发工资，还款日恰巧是钱花光光的时候，每天还款很尴尬	ADV
花呗还款日最好能自定义一下，不然9号偿还，然而十几号才发工资，还款日恰巧是钱花光光的时候，每天偿还很尴尬	ADV
花最好能自定义一下不然9号，然而十几号才发工资，还款日正好是光光时候，还款	ADV
花呗还款日最好能自订一下，不然9号借款人，然而十几号才发工资，还款日恰好是钱花光光的时候，每次借款人很尴尬	ADV
花呗还款日最好自定义一下，不然还款，然而十几号才发工资，还款日正好是钱花光光时候，每次还款很	ADV
无法使用流量听歌，就可以用Wi-Fi。打开流量开关，马上就自动关闭了。蜂窝统计数据的职权也是开了的	BR
无法使用流量看电视，只能用Wi-Fi。打开流量开关，马上就自动停用了。蜂窝信息的权限也是开了的	BR
无法使用听歌，只能用WiFi。打开流量开关，马上就自动了。蜂窝权限也是了的	BR
无法使用流量听歌，只能用Wi-Fi。关上流量旋钮，马上就自动关闭了。蜂窝数据的职权也是开了的	BR
无法使用流量听歌，只能用-Fi。打开开关，马上就了。蜂窝数据的权限也是开了的	BR
无法使用流量玩游戏，就可以用Wi-Fi。打开流量开关，马上就手动关闭了。蜂窝数据的权限也是开了的	BR
无法使用流量听歌用Wi-Fi。打开流量开关就自动关闭了蜂窝数据权限也是了	BR
无法使用流量听歌，只能用Wi-Fi。关上流量指示灯，马上就自动关停了。蜂窝数据的权限也是开了的	BR
无法使用听歌，只能用Wi-Fi。打开流量开关，马上关闭了。蜂窝数据的也是开的	BR
独有的音乐互交服务平台，设计风格也很棒	GF
独有的音乐互交平台，设计色彩也很棒	GF
的音乐互交平台，设计风格也很棒	GF
独有的互交平台，风格也很棒	GF
独有的音乐互交平台，设计风格也很酷	GF
所有歌曲都很大的底噪，根本没法听想的话歌曲就都删除了给网易写邮件反应也没回，态度	BR
突然的所有歌曲都有很大的底噪，根本根本无法听到，想重装的话歌曲就都删除了，给网易写email反应也没回，什么态度	BR
突然的所有歌曲都有很大的底噪，根本不了听，想重装的话歌曲就都删除了，给腾讯写邮件反应也没回，什么立场	BR
突然的所有新歌都有很大的底噪，根本不想听，想重装的话新歌就都移除了，给网易写邮件反应也没回，什么态度	BR
的所有歌曲都有的底噪，根本没法听，想的话歌曲就都删除给网易写邮件反应没回，什么	BR
突然的所有歌曲很大的底噪，根本听，想重装歌曲就删除，给邮件反应也没回，什么	BR
的所有歌曲都有很大的底噪根本没法听，想的话歌曲就都删除给网易写也什么态度	BR
突然的所有歌曲都有较大的底噪，根本不想听，想重装的话歌曲就都删除了，给网易写信函反应也没回，什么态度	BR
突然所有歌曲都有很大的，根本没法听想重装的话歌曲就都了，给网易写邮件反应也没回，什么	BR
突然的所有名曲都有很大的底噪，根本没法听，想要重装的话名曲就都删除了，给搜狗写邮件反应也没回，什么态度	BR
你们腾讯也许坑，会员了，好要V会员，要不不能看？你们是女巫么，卸载了	BF
你们腾讯坑，会员了，好要V，要不不能看你们是吸血鬼么，了	BF
你们京东真的坑，会员了，好要I会员，要不不能看？你们是吸血鬼么，卸载了	BF
你们腾讯真的坑，会员了，V要不不能看？你们是吸血鬼么，卸载	BF
模式怎么切换回正常模式单独必须要跟吗？暗黑下朋友圈图片黑色，打不开	ASK
暗影商业模式怎么切换回正常商业模式？不能单独切换吗？必须要跟管理系统吗？暗影商业模式下朋友圈图片黑色，打不开	ASK
暗黑方式怎么转换回正常方式？不能单独转换吗？必须要跟系统吗？暗黑方式下朋友圈图片银灰色，打不开	ASK
暗黑模式切换正常模式不能单独切换？要跟系统吗？模式下朋友圈图片黑色	ASK
暗影模式怎么转换回正常模式？不能单独转换吗？必须要跟系统吗？暗影模式下朋友圈图片粉红色，打不开	ASK
暗黑模式怎么切换回正常模式？不能单独吗？必须要跟系统吗？模式朋友圈，打不开	ASK
暗黑模式怎么切换回正常模式？不能单独切换吗？要跟系统？暗黑模式下朋友圈图片黑色，打不开	ASK
勇者模式怎么转换回正常模式？不能单独转换吗？必须要跟子系统吗？勇者模式下朋友圈图片黑色，打不开	ASK
暗黑模式怎么转换回正常模式？不能单独转换吗？必须要跟模块吗？暗黑模式下朋友圈相片黑色，打不开	ASK
暗黑模式怎么转换回去正常模式？不能单独转换吗？必须要跟信息系统吗？暗黑模式下朋友圈图片黑色，打不开	ASK
暗黑模式切换回正常？不能单独切换吗？要系统吗？暗黑模式下图片黑色，	ASK
勇者商业模式怎么转换回正常商业模式？不能单独转换吗？必须要跟系统吗？勇者商业模式下朋友圈图片黑色，打不开	ASK
暗黑方式怎么切换回正常方式？不能单独切换吗？必须要跟管理系统吗？暗黑方式下朋友圈相片黑色，打不开	ASK
暗黑怎么切换回模式？不能单独切换吗？必须要系统吗？暗黑模式朋友圈黑色，	ASK
暗黑模式怎么正常？切换？必须跟吗？暗黑模式下图片打不开	ASK
暗黑模式怎么切换正常模式？不能切换吗要跟系统？暗黑模式下朋友圈黑色，打不开	ASK
暗黑方式怎么切换回正常方式？不能单独切换吗？必须要跟子系统吗？暗黑方式下朋友圈截图黑色，打不开	ASK
暗黑怎么切换回正常模式？不能单独切换吗？必须要系统？暗黑模式下图片黑色，打不开	ASK
暗影方式怎么切换回正常方式？不能单独切换吗？必须要跟模块吗？暗影方式下朋友圈图片黑色，打不开	ASK
暗黑模式怎么转换回来正常模式？不能单独转换吗？必须要跟系统吗？暗黑模式下朋友圈图片白色，打不开	ASK
暗黑模式切换回正常？单独吗？必须要系统吗？暗黑模式下朋友圈图片黑色，打不开	ASK
暗黑怎么切换回正常模式？不能单独切换吗？必须系统吗？暗黑下朋友圈图片黑色，打不开	ASK
暗黑模式怎么切换正常模式？不能单独切换吗？必须要跟吗？暗黑下朋友圈图片，	ASK
暗黑方式怎么转换回正常方式？不能单独转换吗？必须要跟系统吗？暗黑方式下朋友圈相片黑色，打不开	ASK
暗黑模式怎么切换回来正常模式？不能单独切换吗？必须要跟信息系统吗？暗黑模式下朋友圈截图黑色，打不开	ASK
暗黑模式怎么转换回正常模式？不能单独转换吗？必须要跟信息系统吗？暗黑模式下朋友圈图片白色，打不开	ASK
暗黑商业模式怎么切换回正常商业模式？不能单独切换吗？必须要跟系统吗？暗黑商业模式下朋友圈相片棕色，打不开	ASK
暗黑模式怎么转换回正常模式？不能单独转换吗？必须要跟系统吗？暗黑模式下朋友圈截图银色，打不开	ASK
模式切换回正常模式？单独切换必须要跟？模式下朋友圈图片黑色，打不开	ASK
暗黑模式怎么切换回模式不能单独切换吗？要跟吗？暗黑模式下朋友圈黑色，打不开	ASK
暗黑模式怎么正常模式？不能单独切换吗？必须要系统吗？暗黑模式下朋友圈图片黑色，	ASK
暗影模式怎么切换回去正常模式？不能单独切换吗？必须要跟系统吗？暗影模式下朋友圈图片粉红色，打不开	ASK
暗黑模式怎么转换回正常模式？不能单独转换吗？必须要跟控制系统吗？暗黑模式下朋友圈相片黑色，打不开	ASK
暗黑模式怎么切换回正常不能单独切换吗？必须要跟系统吗？暗黑模式下朋友圈图片黑色打不开	ASK
暗黑模式怎么切换回正常模式？单独切换吗？必须要跟系统吗？暗黑下朋友圈图片黑色打不开	ASK
暗黑模式怎么转换回正常模式？不能单独转换吗？必须要跟子系统吗？暗黑模式下朋友圈图片粉红色，打不开	ASK
勇者方式怎么切换回正常方式？不能单独切换吗？必须要跟子系统吗？勇者方式下朋友圈图片黑色，打不开	ASK
暗黑商业模式怎么切换回正常商业模式？不能单独切换吗？必须要跟子系统吗？暗黑商业模式下朋友圈图片橘色，打不开	ASK
转账和支付都很方便。安全设置很到位。还有它什么银行卡都支持	GF
提款和支付都很方便。安全设很到位。还有一点它什么银行卡都支持绑定	GF
转账和缴付都很方便。安全设很到位。还有一点它什么银行卡都支持绑定	GF
转账和支付都方便。安全。一点什么银行卡都支持绑定	GF
提款和缴付都很方便。安全设置很到位。还有一点它什么银行卡都支持绑定	GF
转账和支付都很方便。安全设置很还有一点它什么支持绑定	GF
更新之后，汇率那一板块变了太多，太商品化了，我想看年/同月/周汇率走势，都看不清楚了，程序员能把它弄回去吗	BF
之后，汇率那一板块变了太，了，我想看年/月/周汇率走势，都了，能把它回来	BF
更新之后，汇率那一相关个股变了太多，太商业化了，我想看年/同月/周汇率走势，都看不出了，程序员能把它搬回来吗	BF
更新之后，汇率那一板块变了太多，太商品化了，我想看年后/同月/周汇率上证指数，都看不到了，程序员能把它弄回来吗	BF
强烈建议增加过滤群对话功能	ADV
强烈建议减少屏蔽群对话功能	ADV
屏蔽对话功能	ADV
强烈建议屏蔽对话功能	ADV
强烈建议增加屏蔽群对话特性	ADV
增加屏蔽群	ADV
强烈建议不断增加屏蔽群对话功能	ADV
强烈建议增加屏蔽群对话基本功能	ADV
要不是为了看你独家垄断，干嘛，你现在app启动就闪退N次。只能试试删包安装。麻烦能不能这种的问题	BR
要不是为了看你独家垄断的NBA，我干嘛会用，然后你现在Store一启动就闪退，闪退了O五次。我只能试试重新删包安装。麻烦能不能消除这种严重的问题	BR
要不是为了看你独家垄断的NBA，我干嘛会用，然后你现在Store一启动就闪退，闪退了N五次。我就可以试试重新删包安装。麻烦能不能消除这种严重的问题	BR
要不是为了看你独家垄断的骑士队，我干嘛会用，然后你现在APP一启动就闪退，闪退了S次。我只能试试重新删包架设。麻烦能不能解决这种严重的问题	BR
要不是为了看你独家垄断NBA会用，然后一启动就，闪退了N次我只能删包能不能解决这种严重的问题	BR
要不是为了看你独家垄断的勒布朗，我干嘛会用，然后你现在Store一启动就闪退，闪退了H次。我就可以试试重新删包安装。麻烦能不能解决这种严重的问题	BR
要不是看独家垄断的NBA，我干嘛会用，然后你现在app一启动就闪退闪退了N次。我试试重新删包安装。麻烦能不能这种的问题	BR
要不是为了看你独家代理垄断的NBA，我干嘛会用，然后你现在app一启动就闪退，闪退了N次。我就可以试试重新删包装上。麻烦能不能消除这种严重的问题	BR
要不是为了看垄断的NBA，我干嘛会用然后你现在app一启动就闪退，闪退了N次。只能试试重新删包安装麻烦能不能解决这种的问题	BR
要不是为了看你独家代理垄断的全明星赛，我干什么会用，然后你现在app一启动就闪退，闪退了N次。我只能试试重新删包安装。麻烦能不能消除这种严重的问题	BR
更新后，群里文件打不开，一直表明正在调用文件，希望开发者尽快更新，解决问题	BR
更新后，群里文件显示正在，希望开发者尽快更新，	BR
后，文件打不开，一直正在，希望尽快更新，解决问题	BR
更新后，群里文件打不开，一直正在加载文件，希望开发者更新解决问题	BR
后，群里打不开一直显示正在加载文件，希望尽快更新，	BR
更新后，群里文件，一直显示正在加载文件，希望开发者尽快更新，解决问题	BR
更新后，群里文件打不开，一直显示正在载入文件，希望开发人员尽快更新，解决问题	BR
更新后，群里文件打不开，一直表明正在存储文件，希望开发者尽快更新，解决问题	BR
Ui，波动了，和崭新系统很搭配，而且看起来比原来舒服多了	GF
Ui，变化，和新系统很搭配，而且比原来舒服多了	GF
Ui，变化，和新系统很，而且看起来原来舒服多了	GF
Ui，变化了，和崭新系统很配上，而且看起来比原来舒服多了	GF
Ui，变化了，和新系统很配搭，而且看起来比原来难受多了	GF
让我看到音乐不单单是用来听的，还是可以用来观赏的	GF
让我看到音乐不单单是用来听到的，还是可以用来欣赏的	GF
让看到音乐不单单是听的，还是可以欣赏的	GF
让我看到流行歌曲不单单是用来听的，还是可以用来欣赏的	GF
我看到不单单是用来听的还是用来欣赏的	GF
与A1893版本9。7寸ipad不适用，只能显示大概三分之一个屏幕，周围留有大范围的黑屏部分，显示部分大致不相上下与6寸手机屏幕大小，望看到此评论者后尽快改进	BR
97寸iPad不，只能大概三分之一个屏幕，周围留有大范围黑屏部分，显示部分大致相仿与6寸手机屏幕大小，望看到此后	BR
与A1893版9。7英寸iPad不适用，就可以显示大概三分之一个屏幕，周围留有大范围的黑屏部分，显示部分大致相差无几与6英寸手机屏幕大小，望看到此评论后尽快进一步改进	BR
与A1893版本9。7寸苹果不适用，只能显示大概三分之一个大屏幕，周围留有大范围的黑屏部分，显示部分大致相差无几与6寸手机大屏幕大小，望看到此评论后尽快改进	BR
与A1893版。7寸iPad不适用，只能显示个屏幕，周围留有大范围黑屏部分，显示部分大致相仿与手机屏幕大小，望看到此评论尽快改进	BR
与97iPad适用，只能显示大概三分之一个屏幕，大范围的黑屏部分，显示部分大致相仿与6寸手机屏幕大小看到后尽快	BR
A18939。7寸iPad不，大概三分之一个屏幕，周围留有大范围的黑屏部分，显示部分大致与6寸手机屏幕大小，望看到此评论后尽快改进	BR
与A1893版本9。7寸iPad不适用，只能显示大概三分之一个画面，周围存有大范围的黑屏部分，显示部分大致相仿与6寸手机画面大小，望看到此评论后尽快进一步改进	BR
与A1893版本9。7寸iPad不适用，只能显示大概三分之一个屏幕，周围留有大范围的黑屏部分，显示部分大致相若与6寸iPhone4屏幕大小，望看到此影评后尽快改进	BR
与A18939。7寸iPad不适用，只能显示大概个屏幕，周围留有大范围部分，显示部分大致与手机屏幕大小，望看到评论尽快	BR
，清新、简单、实用	GF
新版本很赞，清新简单、实用	GF
新版本很赞，清新、单纯、实用	GF
可以改微信号就好。可以多次号好。可以多次改号就好	ADV
微信号就好。可以多次改微信就好。可以多次改微信号就好	ADV
可以多次改QQ号就好。可以多次改QQ号就好。可以多次改QQ号就好	ADV
可以多次改微信号好。可以多次微信号。可以多次改微信号好	ADV
可以多次改微信号就好。多次改微信号就。可以改微信就好	ADV
可以多次改微信就好。可以多次改微信号就好。可以改微信号好	ADV
微信发不，下载不了，卸载微信以后还是不行，弄的连以前的都了，发也发不出去，下载也下不了，没意思，哎。这些漏洞修复	BR
微信表情发不，下载不了，卸载下载微信以后还是不行，弄连以前的表情都没有了，发也发下载也下不了，哎。这些漏洞还是好好修复	BR
微信表情发不出去，下载不了，卸载下载微信以后还是不行，的连以前的表情都没有了，发也发不，下载也不了，没意思，。这些漏洞好好修复	BR
微信表情发不出去，iTunes不了，卸载iTunes微信以后还是没用，搬的连以前的表情都没有了，发也发不出去，iTunes也下不了，没意思，哎。这些安全漏洞还是好好修复吧	BR
微信表情不，下载，卸载下载微信以后还是不行，弄的的表情都没有了发也发不出去，下载也下不了，哎。这些漏洞还是修复	BR
微信表情发不出去，下载不了卸载下载微信还是，弄的连以前的表情都没有了发也发不出去，下载也下不了，没意思，哎。漏洞还是好好修复吧	BR
QQ表情发不出去，上传不了，卸载上传QQ以后还是没用，弄的连以前的表情都没有了，发也发不出去，上传也下不了，没意思，哎。这些漏洞还是好好修整吧	BR
QQ眼神发不出去，下载不了，卸载下载QQ以后还是不行，搬的连以前的眼神都没有了，发也发不出去，下载也下不了，没意思，哎。这些漏洞还是好好整修吧	BR
我感觉很棒，就是一次就可以下一个视频，能再多点就好了	ADV
我感觉不错，就是一次只能一个视频，能再多点就好	ADV
我感觉不错，就是一次就可以下一个录像，能再多点就好了	ADV
我感觉不错，就是一次只能下一个视频能再多点好了	ADV
感觉，就是一次只能一个视频，能再多点就好了	ADV
我感觉，就是一次只能下一个视频，能再好了	ADV
感觉不错，就是一次只能下能再就好了	ADV
我感觉很棒，就是一次只能下一个片段，能再多点就好了	ADV
我感觉不错，就是一次就可以下一个片段，能再多点就好了	ADV
谁要你们的赏金？你们有什么资格赏别人？拿自己当棵葱了？看见这个字就恶心，对用户连最起码的尊重都没有还谈什么用户体验	BF
谁要的赏金？你们有什么资格赏别人？真拿自己当棵了？看见这个字就，对用户连的都没有，还谈什么用户体验	BF
谁要你们的赏金？你们有什么资格赏别人？吗拿自己当棵葱了？看见这个字元就呼吸困难，对用户连最起码的认同都没有，还谈什么用户体验	BF
谁要你们的赏金？你们有什么资格赏别人？吗拿自己当棵葱了？看见这个字元就恶心，对客户端连最起码的认同都没有，还谈什么客户端体验	BF
谁要的赏金？有什么资格赏？拿自己当棵葱了？看见这个字就恶心，对用户的尊重都没有，还谈什么用户体验	BF
希望会员价格昂贵，广告时间短	GF
希望会员价格便宜，广告	GF
希望会员价格便宜，广告短	GF
希望会员价格便宜，广告时间长	GF
科技是时时刻刻监视你吗打卡固定手机拍照劳改犯也不过如此，希望在人道方面能多些进步，这种压榨到底想要换来些什么？还有，强制使用任何app的要求是垃圾	ADV
是监视你的隐私吗？打卡手机还要拍照，劳改犯也不过如此希望人道方面能多些进步，这种压榨到底想要什么？还有，强制使用任何app的要求都是垃圾	ADV
科技是用来时时刻刻监控你的隐私吗？打卡固定手机还要偷拍，劳改犯也不过如此，希望在人道方面能多些进步，这种压榨到底想换来些什么？还有，强制使用任何Store的要求都是废物	ADV
是监视你的隐私吗？打卡固定手机还要拍照，劳改犯不过如此，希望在人道方面能多些进步，这种压榨到底想要换来些什么？还有强制使用任何都是垃圾	ADV
科技是用来时时刻刻监视你的个人信息吗？打卡固定笔记本还要拍照，劳改犯也不过如此，希望在人道主义方面能多些进步，这种压榨到底想要换来些什么？还有，强制使用任何离线的要求都是废物	ADV
科技是用来时时刻刻你的隐私打卡固定手机还要拍照，劳改犯也不过如此，在人道方面能多些进步，这种压榨到底换来什么？还有，强制app的要求都是	ADV
科技是时时刻刻监视你隐私吗？打卡固定手机拍照也不过如此在人道方面能多些进步这种压榨想要换来什么？，强制任何app的要求都是	ADV
信息技术是用来时时刻刻监控你的隐私吗？打卡固定手机还要拍照，劳改犯也不过如此，期望在人道主义方面能多些进步，这种压榨到底想换来些什么？还有，强制使用任何app的要求都是垃圾	ADV
请问这么多年了为什么一直不设夜间模式	ASK
请问这么多年了为什么一直不设置白天模式	ASK
多年了为什么一直不模式	ASK
请问多年为什么一直不设置	ASK
这么多年了一直不夜间模式	ASK
请问这么十多年了为什么一直不设置夜间模式	ASK
请问了为什么不设置夜间模式	ASK
请问这么多年了为什么一直不设立夜间模式	ASK
请问这么多年了为什么一直不夜间模式	ASK
请问这么二十多年了为什么一直不设置夜间模式	ASK
请问这么多年为什么一直不设置模式	ASK
请问这么了为什么一直不设置夜间模式	ASK
请问这么多年了为什么一直不设置日间模式	ASK
请问多年为什么一直不夜间模式	ASK
请问这么多年了为什么一直不设置夜间商业模式	ASK
请问这么多年了一直不设置夜间模式	ASK
请问这么多年了为什么一直不增设夜间模式	ASK
这么了为什么一直不模式	ASK
请问这么十余年了为什么一直不设置夜间模式	ASK
请问这么多年了一直不夜间模式	ASK
请问这么近十年了为什么一直不设置夜间模式	ASK
请问这么多年为什么一直不设置夜间模式	ASK
请问这么多年了为什么一直夜间模式	ASK
这么了为什么一直不夜间模式	ASK
请问这么多年了为什么不设置夜间模式	ASK
请问这么多年了一直设置夜间模式	ASK
在更换头像之后群头像还是不会，除非改群才会刷新，希望可以尽快修复	BR
在更换头像之后群头像还是不会变，除非改一下群名字才会刷新纪录，希望可以尽快重建	BR
在更换之后头像还是不会变，除非改一下名字才会刷新可以	BR
在更换头像之后群头像还是不会变，除非改一下群名字才会刷新，期望可以尽快复修	BR
在更换画像之后群画像还是不会变，除非改一下群名字才会刷新，期望可以尽快修复	BR
在更改头像之后群头像还是不会变，除非改一下群名字才会刷新，希望可以尽快加固	BR
在更改头像之后群头像还是不会变，除非改一下群名字才会刷新，希望可以尽快修整	BR
在更换头像之后群头像还是不会变，除非改一下群名字才会刷新，期望可以尽快修补	BR
在更换头像之后群头像还是不会变，除非改群名字才会刷新，希望可以尽快修复	BR
现在支付宝打不开了是八个意思	BR
支付宝打不开了是几个意思	BR
现在网银打不开了是几个意思	BR
现在打不开了是几个意思	BR
现在打不开是几个意思	BR
现在PayPal打不开了是几个意思	BR
现在支付宝打不开是几个意思	BR
现在支付宝打不开了是几个	BR
很方便，和微信的功能差不多，实用性较好	GF
很方便，和微信的基本功能差不多，实用性很好	GF
很方便，微信的功能差不多，实用性	GF
很方便，和微信的功能差不多，实用性极好	GF
我只想大家你们想要的网易云都可以给。这里面的每个人都有他们自己的故事，而在看他们的故事的同时仿佛能看到自己影子。我已经离不开网易云了，因为它既能让看到又能让我想要。我还是很喜欢	GF
我只想告诉大家你们想要的网易云都可以你们。这里面每个人都有他们的故事，而看的故事的同时仿佛看到自己的影子。已经离不开云，因为它能让我看到她又我想要忘掉她。我还是很你	GF
我只想说大家，你们想的腾讯和云都可以给你们。这里面的每个人都有他们自己的故事，而在看他们的故事的同时好像能看到自己的影子。我已经离不开腾讯和云了，因为它既能让我看到她又能让我想忘却她。我还是很偏爱你	GF
我只想说大家，你们想的新浪云都可以给你们。这里面的每个人都有他们自己的小说，而在看他们的小说的同时好似能看到自己的影子。我已经有赖于新浪云了，因为它既能让我看到她又能让我想忘掉她。我还是很偏爱你	GF
我只想告诉大家，你们想要的网易云可以给你们。这里面的每个人都有他们自己的故事，看他们的同时仿佛能看到的影子。我已经离不开网易了，因为能让我看到又能我想要她。我还是很喜欢	GF
不错的应用软件，正在试用，下一步全面推广	GF
不俗的软件，正在试用，下一步全面推广	GF
很棒的软件，正在试用，下一步全面推广	GF
不错的软件，正在试用，下一步	GF
钉钉里面可以使用电话会议，也可以考勤，是款非常极好办公应用软件	GF
钉钉可以电话会议也可以考勤是款非常不错软件	GF
钉钉里面可以使用电话会议，也可以考勤，是款非常极好办公软体	GF
很工作交流app	GF
一个很不错工作交流app	GF
一个很不错工作app	GF
一个很不错的工作文化交流app	GF
好用方便跨时代的无线通信软件	GF
好用方便跨时代的通讯	GF
好用方便跨时代的通讯硬件	GF
的功能很受用，电话也很受用100个赞	GF
Ding的功能很受用，免费来电也很受用。100个赞	GF
Ding的机能很受用，免费电话也很受用。100个赞	GF
新手机出了这么久还不适配	BF
新手机了还适配	BF
iPhone4出了这么久了还不适配	BF
为什么跟我的Ipad不相容。上传不了，哪里出了问题	ASK
为什么跟的不兼容。下载不了，出了问题	ASK
为什么跟我的Ipad不相容。iTunes不了，哪里出了问题	ASK
为什么跟我的Ipad不兼容不了，哪里出了问题	ASK
为什么的Ipad不。下载不了，哪里出了问题	ASK
为什么跟的Ipad不兼容。下载，哪里出了问题	ASK
为什么跟我的Ipad不。不了哪里出了问题	ASK
为什么跟的不。，出了问题	ASK
为什么跟我的Ipad不兼容。下载不了，哪里问题	ASK
为什么跟我的Ipad不相容。点播不了，哪里出了问题	ASK
为什么跟我的Ipad不相容。订阅不了，哪里出了问题	ASK
跟我的不兼容。下载不了，哪里出了	ASK
为什么跟我的Ipad不兼容。下载不了，哪里出了	ASK
我的Ipad不兼容。下载不了，哪里出了问题	ASK
为什么跟我的Ipad兼容。下载不了，哪里出了问题	ASK
跟我的Ipad不兼容。下载不了，哪里出了问题	ASK
为什么跟我的不兼容。不了，哪里出问题	ASK
为什么跟我的Ipad。下载不了，哪里出了问题	ASK
为什么跟我的Ipad不不了，哪里出了问题	ASK
为什么跟我的Ipad不相容。浏览不了，哪里出了问题	ASK
为什么我的Ipad。下载不了哪里出了问题	ASK
为什么跟我Ipad不兼容。下载不了，出了	ASK
为什么我的Ipad不兼容。下载不了，哪里出了问题	ASK
我问你暗黑模式出不甭整没用，所谓的不想大家晚上睡觉的时间。赶紧出暗黑模式	ADV
我就问你模式你还是不出，那些没用的，所谓的耽误大家睡觉的时间。赶紧出模式	ADV
我就问你暗影商业模式你出还是不出，甭整那些没用的，所谓的不想耽搁大家晚上睡觉的时间。赶紧出暗影商业模式	ADV
我就问暗黑模式出不，甭整那些没用的，所谓的不想耽误晚上睡觉的时间。赶紧出	ADV
我就反问你暗黑模式你出还是不出，甭整那些没用的，所谓的不想耽搁大家晚上睡觉的时间。二话不说出暗黑模式	ADV
我就你暗黑模式你出还是不出，甭整那些没用的不想耽误晚上睡觉时间。赶紧出暗黑模式	ADV
我就问你暗黑方式你出还是不出，甭整那些没用的，所谓的不该耽误大家晚上睡觉的时间。赶快出暗黑方式	ADV
我就问你暗黑模式你出还是出，那些没用，所谓的不想耽误晚上的时间赶紧出暗黑模式	ADV
就你暗黑模式你不出，甭整那些没用的，所谓的不想耽误大家晚上睡觉的。赶紧出暗黑模式	ADV
我就问你暗影模式你出还是不出，甭整那些不行的，所谓的不想耽误大家晚上睡觉的时间。马上出暗影模式	ADV
突然在点开微信的时候，出现了白板，里面所有的联系人出现了丢失，这个bug	BR
突然在点开的时候，出现了白板近期联系人都出现了丢失，这个bug	BR
在微信的时候出现了白板，所有的近期联系人都出现丢失这个bug	BR
突然在点开QQ的时候，出现了白板，里面所有的近期联络人都出现了丢失，这个bug	BR
突然在点开微信的时候，出现了白板，里面所有的近期联络人都出现了丢失，这个Bug	BR
突然在点开的时候，出现了白板，里面所有的联系人都出现丢失这个	BR
突然在点开微信的出现白板，里面所有的近期联系人出现了丢失，这个bug	BR
突然在点开微信时候，出现了白板，里面所有的近期联系人都了丢失，这个bug	BR
突然在点开微信的时候，出现了白板，里面所有的今年以来联系人都出现了丢失，这个Bug	BR
新版的气泡颜色比较柔和，看上去不再刺眼了新的，已读，展开列表去看，的是否已读了。猥琐，不要浪，再接再厉	GF
新版的气泡颜色比较柔和，看上去不再刺眼了。喜欢做，已读功能，不用展开列表去想，的是否了。猥琐发育，浪	GF
新版的气泡紫色比较柔软，看上去不再刺眼了。喜欢崭新做的，已读功能，不用进行列表去看想，的人是否已读了。猥琐发育，不要浪，再接再厉	GF
的颜色比较柔和，看上去不再了。喜欢新做的，，不用展开列表去看想，的人了。猥琐发育，不要浪，再接再厉	GF
现在要么播出不了，要么要会员，借钱听到，对于我们这种不追新歌，不为追星的人来说心好累，幸好还有网易音乐创作，开心，好多歌曲都能听到	GF
现在要么播映不了，要么要会员，要钱听到，对于我们这种不追新歌，不为追星的人来说心好累，幸而还有网易音乐，难过，好多歌曲都能听到	GF
现在要么播不了，要么要，要钱听，对于我们这种不新歌不追星好累，幸好还有网易音乐，开心，好多歌曲都能听	GF
要么不了，要么要会员，要钱听，对于我们追，不为追星的人心好累，幸好还有音乐，好多歌曲能听	GF
天天启动就是让我评论家，我也是够了	BF
天天启动就是我，我也是够了	BF
天天启动就是让我评论，我也是这么了	BF
此插件从视觉效果上看比较精细，用起来也比较方便，上佳	GF
从视觉效果上看比较精细，起来也比较方便，不错	GF
此软件从舞台效果上看比较细致，用起来也比较方便，不错	GF
此软件从视觉效果上看比较也比较，不错	GF
企业IM，在集团信息化应用整合方面真的有很多惊喜	GF
不单单是个企业IM集团信息化应用整合方面真的有很多	GF
不单单是个金融机构IM，在投资公司信息化应用整合方面真的有很多惊喜	GF
不单单是个中小企业IM，在集团公司信息化应用整合方面真的有很多惊喜	GF
网易云不只是，一个大家分享故事的很棒	GF
网易云，不只是听歌，一个大家能分享故事的App，很酷	GF
网易云，不只是玩游戏，一个大家能分享故事的App，很棒	GF
网易云，不只是听歌，大家能分享故事APP，很棒	GF
你不是让给意见嘛，庆余年是怎么回事，也冲了50也花了，你不是更新日多看6集嘛？我6集呢？你这也忒厚道了，别人都当傻子呗	BF
你不是让予意见建议嘛，庆三十多年是怎么回事，会员也冲了，50也花了，你不是更新日多看6集嘛？我6集呢？你这也俄斯不厚道了，MB拿别人都当疯子呗	BF
你不是让给意见建议嘛，庆十余年是怎么回事，会员也冲了，50也花了，你不是更新日多看6集嘛？我6篇呢？你这也忒不厚道了，GHz拿别人都当疯子呗	BF
新版色调变沉了，不难看啊	BF
新版色彩变沉了，不好看啊	BF
新版色调了，不好看	BF
除非脑部抽了，以后千万不要用苹果支付，首先我对网易录像没有什么意见，纯属是对苹果支付账单有意见，每天都是我支付开业会员有问题，每天都是不到账打客服电话，我都醉了	BF
除非脑部抽了，以后千万不要用苹果缴付，首先我对腾讯截图没有什么意见建议，纯属是对苹果缴付账单有意见建议，每次都是我缴付开通会员有问题，每次都是不到账打客服电话号码，我都醉了	BF
除非脑抽，千万不要用苹果支付首先腾讯没有，纯属是对支付账单有意见每次都是我开通会员有问题，每次都是打客服电话，我都醉了	BF
除非大脑抽了，以后千万不要用苹果支付，首先我对新浪音频没有什么意见，纯属是对苹果支付账单有意见，每天都是我支付开通会员有问题，每天都是不到账打客服人员电话，我都醉了	BF
有了微信之后，亲人聊天挺。省点话费同时给那些不要脸人了。需要整改。严加防范	GF
有了微信之后吧，有时候和亲人挺。也省点话费。但是同时那些的人与方便了。需要整改严加防范	GF
有了微信吧，有时候和亲人挺方便。也话费了。同时也给那些不要脸的人与了。需要整改严加防范	GF
有了微信之后吧，偶尔和亲人闲聊挺方便。也省点话费了。但是同时也给那些不要脸的人与方便了。需要自查自纠。严加防范	GF
尊敬的广大群友们相信都是支付宝的用户，因为这是改变大家生活及行为习惯软件，不幸的是支付宝的却把这种拥护当成了随意，试问强制更新和强奸有何差异？醒醒吧，强奸犯们	BF
尊敬的广大群友们，相信大家都是京东的用户，因为这是一个改变大家日常生活及行为习惯的软件，但意外的是京东的决策人员却把这种拥戴当成了随意驱使，试问强制更新和施暴有何差异？醒醒吧，强奸犯们	BF
的群友们，相信大家都是支付宝的用户，因为这是一个改变生活及的软件但是支付宝的决策人员却把这种拥护当成随意驱使试问更新强奸有何醒醒吧，们	BF
信赖的广大群友们，相信大家都是支付宝的用户，因为这是一个改变大家生活及行为习惯的软件，但意外的是支付宝的决策人员却把这种拥护当成了随便驱使，试问强制性更新和强奸有何差别？醒醒吧，强奸犯们	BF
原本就充了会员，还要逼得粉丝再去充超级会员，想割韭菜也不要吃相这么难看吧	BF
本来就充了会员，还要逼迫影迷再去充超级会员，想割韭菜也不要吃相这么难看吧	BF
原本就充了会员，还要逼粉丝再去充超级会员，想割韭菜也不要吃相这么好看吧	BF
录像大小屏缩小不了，醉了	BF
屏缩小不了醉了	BF
视频大小屏缩减不了，醉了	BF
可能是版本用了，更新新版本界面采用了大蓝，这是和微信的大绿形成吗？没必要吧，人家小绿最起码眼色，这个界面和视觉色系是不想说什么。还用了大行间距、大字号，这是要多大	BF
可能是之前版本用生活习惯了，从更新后新版本用户界面使用了大蓝，这是和QQ的大绿形成呼应吗？没必要吧，人家小绿最起码是护眼色，这个用户界面和听觉主色系简直是没法说什么。还用了大行间距、大字号，这是要多大	BF
可能是之前标准版用习惯了，从更新后新版本界面采用了大黑，这是和QQ的大绿形成呼应吗？没必要吧，人家小绿最起码是护眼色，这个界面和美感主紫色简直是想说什么。还用了大行间距、大字号，这是要多大	BF
可能是之前标准版用生活习惯了，从更新后新版本快捷键采用了大绿，这是和微信的大绿形成呼应吗？没必要吧，人家小绿起码是护眼色，这个快捷键和美感主色系简直是不想说什么。还用了大行间距、大字号，这是要多大	BF
是版本用习惯了，从更新后新版本界面采用了蓝，是微信的大绿形成呼应？没必要吧，人家小绿最起码是护，这个界面和视觉主色系简直是说什么还用了大行间距大字号这是要多	BF
网易云你就是个垃圾，什么歌都不能听，什么歌都没版权，你索性破产倒闭吧	BF
网易你个垃圾，什么歌都不能听，什么歌都版权你干脆倒闭吧	BF
网易和云你就是个垃圾，什么歌都不能听，什么歌都没改编权，你干脆倒闭吧	BF
搜狗云你就是个垃圾，什么歌都不能听，什么歌都没版权，你干脆宣告破产吧	BF
网易云你就是个垃圾，什么歌不能听什么歌都没版权，你吧	BF
现在标准版把NBA板块合并到篮球里，很不给力啊，看比赛也不方便，强烈建议恢复NBA板块	ADV
现在版本把板块合并到体育，很不给力啊，看比赛也不方便强烈建议恢复NBA	ADV
现在标准版把MVP板块合并到体育里，很不给力啊，看比赛也不方便，强烈建议恢复MVP板块	ADV
现在版本把全明星赛板块分拆到体育里，很不给力啊，看比赛也不方便，强烈建议恢复全明星赛板块	ADV
版本把NBA板块合并体育里，很不给力啊，看也强烈建议恢复NBA板块	ADV
现在版把NBA龙头股合并到体育里，很不给力啊，看比赛也不方便，强烈建议恢复NBA龙头股	ADV
现在版本把NBA板块合并体育里，很不给力看比赛不方便，强烈建议恢复NBA板块	ADV
现在版本把NBA龙头股合并到体育里，很不给力啊，看表演赛也不方便，强烈建议恢复NBA龙头股	ADV
非常棒的一款视频用户端	GF
非常棒一款视频客户端	GF
非常棒的视频客户端	GF
时间来个500起步就好啦。我生活习惯了有事没事丁丁一下了	ADV
时间来个500就我习惯了有事没事丁丁一下了	ADV
时间来个起步就好啦我习惯了有事没事一下	ADV
时间来个起步就好啦。我习惯了一下	ADV
时间来个500就好啦我习惯了一下了	ADV
时间来个500起步好啦。我习惯了有事没事一下了	ADV
很好，但是页面更简便点的就好了	ADV
很好，但是页面简单点的好了	ADV
很好，但是首页更简单点的就好了	ADV
很好但是点的就好了	ADV
很好，页面更点就好了	ADV
很好，但是关键字更简单点的就好了	ADV
很好，但是页面更简单就了	ADV
很好，但是页面更简单点就好了	ADV
很好，但是页面更非常简单点的就好了	ADV
很烂的插件，工作了的事情竟然没有记录。没有记忆基本功能	BF
很烂的插件，工作了的事竟然没有记录。没有记忆功能	BF
很烂的软件工作了的事情竟然没有记录。没有记忆	BF
很烂的软件，工作了的竟然没有记录。没有功能	BF
的软件，工作了的事情竟然没有记录。记忆功能	BF
撒鼻应用软件，一直闪退，定位不准	BR
撒鼻软件，一直闪退，定位不许	BR
撒鼻开发工具，一直闪退，定位不准	BR
撒鼻软件，一直，定位不准	BR
软件，一直闪退，定位不准	BR
撒鼻软件，一直闪退，定位	BR
撒鼻软体，一直闪退，定位不准	BR
撒鼻应用程序，一直闪退，定位不准	BR
撒鼻，一直闪退，定位不准	BR
这次的版面真不方便，还没有以前的好，精确简单一点比较好，最新版本的人简直智障	BF
这次的版面真不方便，还没有以前的好，直观简单一点比较好，最新版本人弱智	BF
这次的版面真不方便，还没有以前的好，直观直观一点比较好，最新版的人简直弱智	BF
这次的版面真不方便，还没有以前的好，清晰简单一点比较好，最新版的人简直弱智	BF
的不方便还以前的好，直观简单一点比较好，最新版本人简直弱智	BF
能更新出一个月可见。别五天。一个月是最好的	ADV
能更新出一个月可见别三天。一个月最好的	ADV
能更新出一个月可见。别八天。一个月是最好的	ADV
能更新出半年可见。别三天。半年是最好的	ADV
更新可见。别三天。一个月是最好的	ADV
能更新出三个月可见。别三天。三个月是最好的	ADV
能更新出一个月可见。别三天是最好的	ADV
能更新出一个月可见。别三天。一个月最好的	ADV
更新出一个月可见别三天。一个月最好的	ADV
能更新出一个月可见。别六天。一个月是最好的	ADV
确实很棒，看了不少小说，都是免费的，中途也没有什么广告宣传之类的，挺不错的	GF
的确不错，看了不少小说，都是免费的，中途也没有什么商业广告之类的，挺不错的	GF
确实看了不少小说，都是免费的，中途也没有什么广告之类的，挺不错的	GF
确实看了不少小说，都是免费的，中途也没有什么广告之类的，挺不错	GF
确实，看了不少小说，都是，中途也没有什么广告之类的	GF
用过最棒的支付软件马总的产品	GF
用过最棒的缴付软件，马总的产品	GF
用过最棒的支付，马总产品	GF
最棒支付软件，马总的产品	GF
挺久，，我唱片	GF
用挺久，挺好，我喜爱这种黑胶唱片的播放画面	GF
用挺久，挺好，我喜欢这种黑胶唱片的播送画面	GF
用挺久，挺好我这种黑胶唱片的播放画面	GF
用久，挺好我喜欢这种黑胶唱片的	GF
多请一个人开发一下wp客户端不行吗，这么大集团对客户这么不认同真是醉了	ADV
多请一个人开发一下wp客户端没用吗，这么大集团对客户这么不尊重真是醉了	ADV
多请一个人一下wp客户端不行吗，这么大公司对客户这么不尊重真是醉了	ADV
多请一个人开发一下wp客户端没用吗，这么大公司对客户这么不认同真是醉了	ADV
多一个人开发一下wp客户端不行吗，这么大公司对客户这么不尊重真是	ADV
多请一个人合作开发一下wp服务器不行吗，这么大公司对客户这么不尊重真是醉了	ADV
多请一个人wp吗，大对客户这么不尊重真是醉	ADV
多请一个人开发一下wp客户端不行这么大公司对客户这么不真是了	ADV
其实是很不错的，可是再更新其他功能，让它更加	ADV
其实它是很不错的，可是还可以再更新其他特性，让它更加便利	ADV
其实是很不错的，可是还其他功能，让它更加方便快捷	ADV
其实它是很不错的，可是还可以再更新其他特性，让它更加快捷	ADV
其实它是很不错的，可是还可以再更新其他特性，让它更加便捷	ADV
其实它是很很棒的，可是还可以再更新其他机能，让它更加方便快捷	ADV
它是很不错，可是还可以再更新其他功能，让方便快捷	ADV
其实它是很不错的，可是还可以再更新其他系统，让它更加便利	ADV
其实它不错，可是还可以更新其他功能让它更加方便快捷	ADV
用户体验很差，，我别的软件都是很快就能用了就这个超级慢，打开半天还在转圈圈，连页面都加载不全	BR
用户体验很差，界面载入很慢，我别的软件都是很快就关上能用了，就这个APP超级慢，关上一会还在转圈圈，连配置文件都载入不全	BR
移动用户体验很差，界面存储比较慢，我别的应用软件都是很快就打开能用了，就这个APP超级慢，打开半天还在转圈圈，连页面都存储不全	BR
用户体验，界面加载，我别的软件都是很快就打开能用，就这个APP超级打开半天还在，连页面都加载不全	BR
用户体验很差，界面加载很慢我别的软件都能用了，就这个APP慢，打开半天还在转圈圈，页面加载不全	BR
用户体验，界面加载很慢，别的都是就打开了，就这个APP慢，半天还在转圈圈，连页面都不全	BR
用户体验很差，界面加载很慢，别的软件都是就打开能用了，就这个APP超级慢，还在转圈圈，连页面都不全	BR
用户体验很差，界面加载很慢，我别的都是很快就打开能用，就这个APP超级慢，打开半天在，连页面都不全	BR
用户体验很差，界面读取非常快，我别的软件都是很快就打开能用了，就这个app超级慢，打开一会还在转圈圈，连页面都读取不全	BR
用户感受很差，界面读取很慢，我别的硬件都是迅速就打开能用了，就这个APP超级慢，打开半天还在转圈圈，连页面都读取不全	BR
网易音乐很棒，但是有小小的意见那个每日歌单有但是只会出来6个，点的话，找自己喜欢的歌单要找很久很久非常	ADV
百度云电子音乐真的很酷，但是我有一个小小的意见，那个每日歌单他虽然有很多个但是只会出来6个，点进去的话，找自己钟爱的歌单，要找很久很久，非常的麻烦	ADV
搜狗和云现代舞真的很酷，但是我有一个小小的意见，那个每日歌单他虽然有很多个但是只会出来6个，点进去的话，找自己喜欢的歌单，要找很久很久，非常的麻烦	ADV
网易真的，我有一个小小的意见，那个每日歌单他虽然个但是只会6个，进去的话，找自己的歌单，要找很久很久，非常的麻烦	ADV
网易云音乐真的很棒，但是我一个小小的意见，那个每日歌单他虽然有很多个但是只会出来6个，点进去的话，找喜欢的歌单要找，非常的麻烦	ADV
网易云音乐真的很棒，我一个小小的意见，每日歌单他虽然有很多个但是6个，点进去，找自己歌单找很久很久，非常	ADV
网易和云音乐创作真的很酷，但是我有一个小小的意见，那个每周歌单他虽然有很多个但是只会出来6个，点进去的话，找自己喜欢的歌单，要找很久很久，非常的麻烦	ADV
网易云流行音乐真的很酷，但是我有一个小小的意见，那个每周歌单他虽然有很多个但是只会出来6个，点进去的话，找自己钟爱的歌单，要找很久很久，非常的麻烦	ADV
网易云真的很棒但是有一个，那个歌单有很多个但是只会6个，进去的话找喜欢的歌单，要找很久很久非常麻烦	ADV
百度云音乐就算很棒，但是我有一个小小的意见建议，那个每日歌单他虽然有很多个但是只会出来6个，点进去的话，找自己讨厌的歌单，要找很久很久，非常的麻烦	ADV
电话会议功能，文件管理功能打卡，对办公来说好的不得了，给个人再也不用其他人抢了	GF
电话会议功能，文档管理功能，阅读打卡，对办公来说好的不得了，给个人发红包再也无须忧心其他人抢了	GF
功能，文件管理功能阅读打卡，办公来说好不得了，给再也不用担心其他人抢了	GF
电话会议特性，文件财务管理特性，阅读打卡，对办公来说好的不得了，给个人发红包再也不用担心任何人抢了	GF
为了看陈情令专门出售了会员，结果剧播到五分之一突然提出什么点播制。请直面观众合理诉求:我们婉拒，提前大结局，婉拒超级会员点播，更婉拒不被重视只被说成韭菜割	BF
为了陈情令专门购买了会员，剧播到一半突然提出什么点播制。请正视观众合理诉求我们拒绝，提前大结局，超级会员，更拒绝不被重视只被当作韭菜割	BF
为了看陈情令专门购买了会员，结果剧播到一半突然提出什么点播制。请直面听众合理诉求:我们拒绝，提早大结局，拒绝超级会员点播，更拒绝不被注重只被当作葱割	BF
为了看陈情令专门购买了，结果剧播到一半突然提出什么点播。请正视观众合理诉求:我们拒绝提前大结局，拒绝会员点播更不被只被当作韭菜	BF
广告太长，	BF
没有vip广告时间太长，不太好	BF
没有ip广告太不好	BF
没有vip广告时间实在太长，不好	BF
没有vip商业广告时间太长，不好	BF
自从公司用了这个软件包，整个一生就不分工作与歇息了。慎用啊。能不能开发个功能，晚饭后继续使用影响员工歇息的，一次罚款10万	BF
自从公司用了这个应用软件，整个爱情就不分工作与休息了。慎用啊。能不能开发个功能，下班后继续使用负面影响员工休息的，一次处罚10万	BF
自从公司用了这个软件，整个就工作与了啊。能不能开发个功能，后继续使用影响员工休息的一次万	BF
自从公司用了这个插件，整个人生就不分工作与休息了。慎用啊。能不能研发个功能，下班后继续使用冲击职工休息的，一次罚款10万	BF
自从公司用了这个整个人生就不分工作与了慎用啊不能开发个功能，下班后继续使用员工休息，	BF
陪伴，用上不离开	GF
日常陪伴，用上就不返回	GF
日常陪伴上不离开	GF
日常陪伴用上离开	GF
给普通百姓的社会福利，好好好	GF
给的福利好好好	GF
给平民百姓的福利，好好好	GF
的真的很不错用心	GF
网易的实在很不错，很用心	GF
百度的真的很不错，很用心	GF
网易的真的很不错，用心	GF
新浪的真的很不错，很用心	GF
用，活动，有已经成功，	GF
很好用，有大型活动，有同学已经成功，推荐	GF
这个应用帮我的管理更加高效率及时	GF
这个应用帮我的更加高效及时	GF
这个应用帮我的管理高效及时	GF
刚还清，就不能用了，	BF
刚偿清钱，就不能用了，好尴尬	BF
还清钱，就用了，尴尬	BF
刚还清银子，就不能用了，好尴尬	BF
用了很了才评论，很	GF
用了很久了才文章的，很不错	GF
用了很久了才评论者的，很不错	GF
用了很久才评论的，很不错	GF
如果群聊的时候能加个封禁功能就好了	ADV
如果群聊的时候能加个禁言特性就好了	ADV
如果群聊的能加个禁言功能好了	ADV
如果群聊的时候能加个就好	ADV
如果群聊的时候能加个禁言系统就好了	ADV
如果群聊的能加个禁言功能好	ADV
人在国外，用QQ微博都不能登录帐户，必须提交账号，账号又只能提交86的，这是在搞笑吗？而且不知道为什么一定要提交账号，看电视而已，要出钱不会自己交钱吗，QQ本来都是实名的，和手机号码有啥关系	BR
人在国外，用微博都不能，必须提交手机号，手机号只能提交86的是搞笑吗？而且不知道为什么一定要手机号而已，要花钱自己吗微信本来都是实名的和手机号码有啥关系	BR
人在国外，用微信微博都不能登录账户，必须提交手机号，手机号又只能提交86的，这是搞笑吗？而且知道一定要提交手机号，听歌要花钱不会自己付钱吗，本来都是实名的，有啥关系	BR
人在海外，用QQ微博都不能登录账户，必须报送手机号，手机号又就可以报送86的，这是在搞笑吗？而且不知道为什么一定要报送手机号，听歌而已，要花钱不会自己交钱吗，QQ本来都是实名的，和手机号码有啥矛盾	BR
人在，用微信微博都登录账户，必须提交手机号，手机号又只能提交86的，是在搞笑吗？而且知道为什么一定要提交，听歌而已不会自己，微信本来都是实名的，和手机号码有啥关系	BR
人在国外，用QQ帖子都不能登录账户，必须提交账号，账号又就可以提交86的，这是在搞笑吗？而且不知道为什么一定要提交账号，听歌而已，要花钱不会自己交钱吗，QQ本来都是实名的，和手机号码有啥矛盾	BR
人在国外用微信微博都登录账户，手机号又86的，是在搞笑？不为什么一定要提交手机号，听歌而已要花钱付钱吗，微信本来都是实名的手机号码有啥	BR
人在国外，用微信微博不能登录账户，必须提交手机号，只能的是在搞笑？而且不知道为什么一定要提交手机号，听歌而已要花钱不会自己付钱吗，微信本来都实名的，和有啥	BR
把其他方式付款关闭了，不想用手机银行付款都不行了，不开通信用卡付款的租户，只能用信用卡付款的买家就要付利息，这就是变相收钱，希望手机客户端能越来越方便快捷，不要这样处处计费，让很多好买家失去很多消费者	BF
其他方式付款关闭了，想用手机银行付款都不行不开通付款的信用卡付款的买家付手续费，这就是收钱，希望手机能越来越便捷，不要这样处处收费，让很多买家很多	BF
把其他方式付款关闭了，想用银行都不行了不开通信用卡付款的商户，只能用信用卡付款的买家就要手续费这就是变相收钱，希望手机客户端越来越不要这样处处收费，让很多好买家客户	BF
把其他方式退款关闭了，想用手机银行退款都没用了，不开业信用卡退款的商户，只能用信用卡退款的买家就要交手续费，这就是变相收钱，希望手机服务器能越来越便捷，不要这样处处计费，让很多好买家失去很多客户	BF
把其他方式付款关闭了，想用手机银行付款都没用了，不投入使用信用卡付款的商户，只能用信用卡付款的买家就要付佣金，这就是变相收钱，希望手机浏览器能越来越方便快捷，不要这样处处收费，让很多好买家失去很多消费者	BF
我是老用户了，天天使用支付宝转账下单下单等往来账户，非常实用，五星好评	GF
我老用户了天天使用支付宝转账付款收款等，非常实用五星	GF
我是老用户了，天天使用支付宝信用卡付款收款等往来账户，非常实用，五星赞誉	GF
我是老用户了，天天使用支付宝转账付款收款等往来账户，非常新颖，五星反响	GF
很多QQ音乐要歌，在这都能	GF
QQ音乐付费的这都能下载	GF
很多QQ音乐要付费的经典歌曲，在这都能下载	GF
很多QQ音乐要付费的歌，在这都能点播	GF
T5强制更新以后就各种重播不了了	BR
T5强制更新以后就各种播送不了了	BR
T5强制就各种播放不了了	BR
T5强制更新以后就各种拨放不了了	BR
T5强制更新以后就播放不了了	BR
V60强制更新以后就各种播放不了了	BR
T5强制以后就各种播放不了了	BR
我就想问问为什么这两周我还蚂蚁借呗（主动还款）一直买卖失败？还有转账控制系统也是买卖失败？充值控制系统也是买卖失败	ASK
我就想问问为什么几天我还借呗（主动还款一直交易失败还有转账也失败？充值系统也是交易失败	ASK
我就想问问为什么这几天还蚂蚁借呗（主动还款一直交易失败？还有系统也是交易失败？充值系统也是交易	ASK
我就想要问问为什么这几天我还蚂蚁借呗（主动借款人）一直买卖失败？还有转账系统也是买卖失败？充值系统也是买卖失败	ASK
我就不想问问为什么这几天我还蚂蚁借呗（主动还款）一直买卖失败？还有转账系统也是买卖失败？充值卡系统也是买卖失败	ASK
我就想问问为什么这我还蚂蚁借（主动还款一直失败？还有转账也交易失败？充值系统也是交易失败	ASK
我就问问这几天我还蚂蚁借呗（主动还款）一直交易失败还有转账系统是交易失败？充值也是失败	ASK
我想为什么几天我还蚂蚁借呗（主动还款）一直交易失败？还有系统也是交易失败？系统是交易失败	ASK
我就想问问为什么这几天我还蚂蚁借呗（主动还款）一直买卖失利？还有汇款系统也是买卖失利？充值系统也是买卖失利	ASK
我就不想问问为什么这数日我还蚂蚁借呗（主动还款）一直交易失利？还有转账系统也是交易失利？充值系统也是交易失利	ASK
我这我还蚂蚁借呗（主动一直交易？还有转账系统是交易充值系统是交易失败	ASK
我就想问问为什么这两天我还蚂蚁借呗（主动还款）一直买卖失败？还有转账控制系统也是买卖失败？充值控制系统也是买卖失败	ASK
我就不想问问为什么这几天我还蚂蚁借呗（主动偿还）一直买卖失败？还有转账系统也是买卖失败？充值系统也是买卖失败	ASK
我就想要问问为什么这几天我还蚂蚁借呗（主动还款）一直交易失败？还有汇款子系统也是交易失败？充值子系统也是交易失败	ASK
我想问问为什么这几天我还蚂蚁（主动还款）一直交易失败？还有转账系统也交易失败？充值系统是交易失败	ASK
我就想问问为什么这几天我还蚂蚁借呗（主动还款）一直买卖失败？还有转账模块也是买卖失败？取现模块也是买卖失败	ASK
我就想问问为什么这几天我还蚂蚁借呗（主动借款）一直买卖失败？还有转账信息系统也是买卖失败？充值信息系统也是买卖失败	ASK
我就想问问为什么这几天我还蚂蚁借呗（主动借款人）一直买卖失败？还有转账信息系统也是买卖失败？充值信息系统也是买卖失败	ASK
我就想问问为什么这几天我还蚂蚁借呗（主动借款人）一直买卖失败？还有转账管理系统也是买卖失败？充值管理系统也是买卖失败	ASK
我想为什么这几天我还蚂蚁借呗（主动还款）一直交易失败转账是交易失败系统也是失败	ASK
我为什么这几天我还蚂蚁借呗（主动还款）一直交易失败？还有转账系统也是失败？充值系统也是交易失败	ASK
我就想问问为什么这几天我还蚂蚁借呗（主动还款）一直买卖失败？还有信用卡控制系统也是买卖失败？充值控制系统也是买卖失败	ASK
我就想问问为什么几天我还蚂蚁借（主动还款）一直交易失败？还有转账系统也是交易失败？充值系统也交易失败	ASK
我就想问问为什么这几天我还蚂蚁借呗（主动还款）一直交易失利？还有汇款控制系统也是交易失利？充值控制系统也是交易失利	ASK
我就想问问为什么这几天我还蚂蚁借呗（主动还款）一直交易失败？还有信用卡管理系统也是交易失败？转账管理系统也是交易失败	ASK
我就想问问为什么还蚂蚁借呗（主动还款）一直失败还有转账也是交易？充值系统也交易失败	ASK
我就不想问问为什么这几天我还蚂蚁借呗（主动还款）一直交易失败？还有转账控制系统也是交易失败？刷卡控制系统也是交易失败	ASK
我就想问问为什么这几天我还蚂蚁借呗（主动偿还）一直交易失败？还有信用卡系统也是交易失败？信用卡系统也是交易失败	ASK
我问问为什么这几天我还蚂蚁呗（主动还款）交易失败还有转账系统也是交易失败？充值系统也是交易失败	ASK
我就想问问为什么这几天我还蚂蚁借呗（主动借款）一直买卖失败？还有转账系统也是买卖失败？刷卡系统也是买卖失败	ASK
就想问问为什么这几天我还蚂蚁呗（主动还款）一直交易失败？还有转账也是交易失败？充值系统是交易失败	ASK
我就想问问为什么这几天我还蚂蚁借呗（主动借款人）一直买卖失败？还有转账系统也是买卖失败？刷卡系统也是买卖失败	ASK
我就想问问为什么这一周我还蚂蚁借呗（主动借款）一直交易失败？还有转账系统也是交易失败？充值卡系统也是交易失败	ASK
我就想为什么几天我还蚂蚁借呗主动还款）？还有转账系统也交易失败？充值系统也是失败	ASK
我就想要问问为什么这一个月我还蚂蚁借呗（主动还款）一直交易失利？还有转账系统也是交易失利？充值系统也是交易失利	ASK
我就想问问为什么几天我还呗（还款）一直失败？系统也是交易失败？充值也是失败	ASK
我就不想问问为什么这几天我还蚂蚁借呗（主动还款）一直交易失败？还有转账信息系统也是交易失败？转账信息系统也是交易失败	ASK
我就想问问为什么这几天我还蚂蚁借呗（主动借款）一直交易失败？还有提款系统也是交易失败？转账系统也是交易失败	ASK
我就想问问为什么这几天我还蚂蚁借呗（还款）一直交易失败？还有系统也是交易？充值系统也是交易失败	ASK
小视频，就应该像原来一样小而方便，现在变成全屏一点也不方便还不能退回，笑容也莫名其妙变超级大所以还更模糊	BF
小视频，就应该像原来一样小而方便，现在变成全屏也不方便不能撤回，也莫名变超级大所以还更模糊	BF
小视频，就应该像原来一样方便，现在变成全屏一点也不方便表情也莫名变超级大所以更模糊	BF
小视频，就应该像原来一样小而方便，现在变成全屏一点也不方便还不能撤出，表情也莫名其妙变超级大所以还更模糊不清	BF
朋友推荐的大方，音质也不错还有复古碟片让眼前一亮	GF
朋友推荐用的，简洁大方，音质也上佳。还有复古碟片让人刮目相看	GF
朋友推荐的，简洁大方，音质也不错。还有复古碟片让人眼前一亮	GF
女朋友推荐用的，简洁大方，音质也很棒。还有复古碟片让人眼前一亮	GF
朋友推荐用的，简洁大方，也。还有复古碟片让人眼前一亮	GF
这个标准版不能支持一键转发内容到朋友圈	BF
这个版本不能支持一键内容朋友圈	BF
我昨天上午开通阿里巴巴视频会员，微信支付成功了，为什么阿里巴巴会员到现在没给我开通	BR
我昨天开业腾讯视频会员，QQ支付成功了，为什么腾讯会员到现在没给我开业	BR
我昨天开通腾讯视频会员，QQ缴付成功了，为什么腾讯会员到现在没给我开通	BR
昨天开通腾讯视频会员，微信支付成功了为什么腾讯会员到现在给我开通	BR
我昨天开通腾讯会员微信支付成功了，为什么腾讯会员到现在没给我开通	BR
昨天开通腾讯视频会员，微信支付成功了为什么腾讯会员到没给我开通	BR
我昨天开通视频会员微信支付成功了，为什么腾讯会员到没给开通	BR
一直都是用腾讯会员的，有报道过说会员超前点播的问题要不要吃相难看啊，充为就是看一分多钟的，享受会员能提前看的权利，充会员还有会员广告，想要提前看下集还要继续交费才能，身为会员我想问会员还有什么用吗本身有的权利享受不到	BF
一直都用腾讯会员的，早报道说会员超前点播问题，要不要吃相难看啊的就是不用看一分的广告，享受会员能看的权利充后还有会员广告想要提前还要继续看，身为会员我想问这个会员还有什么用吗？会员本身有的权利不到	BF
一直以来都是用UC会员的，早之前就有报道过写道会员超前点唱的问题，要不要吃相好看啊，充会员为的就是没法看一分多钟的广告，享受会员能提早看的权利，充会员后还有会员广告，想提早看第一集还要继续交费才能看，身为会员我想问这个会员还有什么用吗？会员本身有的权利享受不到	BF
一直以来都是用腾讯会员的，早之前就有媒体报道过说会员超前点播的问题，要不要吃相好看啊，充会员为的就是无须看一分多钟的电视广告，享受会员能提早看的公民权，充会员后还有会员电视广告，想要提早看第一集还要继续缴费才能看，身为会员我想问这个会员还有什么用吗？会员本身有的公民权享受不到	BF
我们什么时候，电台节目上唱歌呢用亚马逊的	ASK
我们什么时候，电台节目上唱歌呢用苹果公司的	ASK
我们时候，电台节目唱歌呢的	ASK
我们什么时候电台节目上呢用苹果的	ASK
我们什么时候，电台节目上演戏呢用苹果的	ASK
什么时候，电台节目上唱歌呢苹果的	ASK
我们什么时候电台节目上唱歌呢用苹果的	ASK
我们什么时候，电台节目上唱歌呢用微软的	ASK
什么时候电台节目上唱歌呢用苹果的	ASK
我们什么时候，电台节目上呢用	ASK
我们什么时候，电视节目上唱歌呢用苹果的	ASK
我们什么时候，广播节目上唱歌呢用苹果的	ASK
我们什么时候电台节目上唱歌呢	ASK
我们什么时候，电台节目上唱歌呢用谷歌的	ASK
我们什么时候，电台节目上呢用苹果的	ASK
我们什么，电台节目上唱歌呢用苹果的	ASK
我们什么时候上唱歌呢用苹果的	ASK
什么时候电台节目上唱歌呢用的	ASK
什么时候，电台节目上唱歌呢用苹果的	ASK
什么，上唱歌用苹果的	ASK
我们什么时候，电台节目上弹钢琴呢用苹果的	ASK
我们什么，电台节目唱歌呢用苹果的	ASK
我们什么时候，电台节目上唱歌呢用小米的	ASK
我们时候，电台节目上唱歌呢用苹果的	ASK
什么时候，电台节目唱歌用苹果	ASK
时候，电台节目上唱歌呢用苹果的	ASK
时候电台节目上唱歌呢苹果	ASK
我们什么时候，电台节目上唱歌呢用iPhone的	ASK
系统无法连接，不了蜂窝状态下，不知道为什么	BR
无法连接，，蜂窝状态下可用，不知道为什么	BR
信息系统无法连接宽频网，登陆不了，蜂窝状态下可用，不知道为什么	BR
系统无法相连接宽频网，登陆不了，蜂窝状态下可用，不知道为什么	BR
系统无法连结有线网，登陆不了，蜂窝状态下可用，不知道为什么	BR
系统无法连接无线网，登陆不了，蜂窝状态下可用，不为什么	BR
信息系统无法相连接无线网，登陆不了，蜂窝状态下可用，不知道为什么	BR
连接无线网，不了蜂窝状态，不知道为什么	BR
系统无法相连有线网，登陆不了，蜂窝状态下可用，不知道为什么	BR
系统无法连接登陆不了，蜂窝下可用，不知道为什么	BR
页面总是闪退。朋友买来的会员无需了，我登录上，自己就闪退了。就我一个人用没有别人	BR
邮箱总是闪退。老友买到的会员不用了，我登录上，自己就闪退了。就我一个人用没有别人	BR
帐号闪退。朋友的，登录上，自己就闪退了就我一个人用没有别人	BR
帐号总是闪退朋友买不用了，我登录上，就闪退了。就没有别人	BR
用户名总是闪退。朋友想买的会员不必了，我登录上，自己就闪退了。就我一个人用没有别人	BR
闪退。朋友的不用了，我登录，了就我人用没有别人	BR
总是闪退。买的会员不用了，我自己就了。就我一个人用没有别人	BR
帐号总是闪退。同事卖的会员无需了，我登录上，自己就闪退了。就我一个人用没有别人	BR
帐号总是闪退。同事买回的会员不必了，我登录上，自己就闪退了。就我一个人用没有别人	BR
除了很多歌没有版权外，反正我也是三个播放器轮著用的	ADV
除了很多歌版权外，反正也是播放器轮著用的	ADV
除了很多歌没有版权外反正我也是几个播放器的	ADV
除了很多歌没有版权外，再说我也是几个播放器轮著用的	ADV
除了很多歌没有版权外反正我是几个播放器轮著用的	ADV
除了很多歌没有版权外，嘛我也是几个播放器轮著用的	ADV
除了很多歌没有版权外，反正也是播放器轮著用的	ADV
除了很多歌没有发行权外，反正我也是几个播放器轮著用的	ADV
除了很多歌没有版权此外，反正我也是几个播放器轮著用的	ADV
一直用着网易云希望越做越好	GF
一直用着网易和云，希望越做越好	GF
一直着云希望越做越好	GF
钉钉打卡法定不打卡也旷工，设计者外国人，或脑子进水	BF
钉钉打卡法定假日不打卡也算旷工，设计者是侨民吧，或脑子进水	BF
钉钉法定打卡也算旷工设计者外国人吧，脑子进水	BF
钉钉打卡法定节假日不也算旷工，设计者是外国人吧，或脑子进水	BF
今天中午更新了，进入京东直接闪退。早知道不更新了	BR
今天中午更新了，进入银联直接闪退。早知道不更新了	BR
今天一大早更新了进入支付宝直接闪退。早知道不更新了	BR
今天一大早更新了，进入直接。早知道不	BR
今天清早更新了，进入PayPal直接闪退。早知道不更新了	BR
今天一大早更新了，进入支付宝直接。知道不更新	BR
推荐流行歌曲功能是用过的软件中最好的	GF
推荐歌曲是用过的软件中最好的	GF
推荐歌曲功能是用过的开发工具中最好的	GF
推荐歌曲功能是用过的软件包中最好的	GF
方便，便捷，高效，绿色，低碳	GF
方便，方便快捷，高效，绿色，低碳	GF
删了重新装也不可以能不能解决一下	BR
删了重新上装也不可以，能不能解决一下	BR
删了重新装也不可以，能不能消除一下	BR
删了重新装不可以，能不能解决	BR
无法设置头像的步骤太过霸道强迫客户，已，希望下个版本	ADV
无法跳过增设头像的步骤，太过霸道，强迫客户，已删除，希望下个版本改良	ADV
无法跳过设置头像步骤，太过霸道，强迫客户，已删除希望版本改进	ADV
无法跳过设置肖像的步骤，太过霸道，强迫客户，已删除，希望下个标准版改进	ADV
无法跳过设置画像的步骤，太过霸道，胁迫客户，已删除，希望下个版本改进	ADV
无法跳过设置头像的步骤，太过霸道，强逼客户，已删除，希望下个版本进一步改进	ADV
无法跳过设置肖像的步骤，太过霸道，强迫客户，已删除，期望下个版本改进	ADV
无法跳过增设头像的步骤，太过霸道，强迫客户，已封禁，希望下个版本改进	ADV
无法跳过设置的步骤，太过，强迫客户，已删除，希望改进	ADV
I8为啥搜索机能用不了？dd？而且更新之后该片板块去哪里了	ASK
I8搜索功能不了？dd？而且更新电影板块去了	ASK
I8为啥搜索系统用不了？dd？而且更新之后恐怖片板块去哪里了	ASK
I8为啥搜寻功能用不了？dd？而且更新之后电影金融板块去哪里了	ASK
I8搜索功能用不了？dd？而且更新电影板块哪里了	ASK
I8为什么搜索功能用不了？dd？而且更新之后经典电影板块去哪里了	ASK
I8为啥搜索功能用不了？而且电影板块去哪里了	ASK
搜索功能用不了？dd？而且之后电影板块哪里了	ASK
I8咋搜索机能用不了？dd？而且更新之后电影板块去哪里了	ASK
I8为啥搜索功能用不了？dd而且更新之后板块哪里	ASK
搜索功能不了dd？而且更新之后电影板块哪里了	ASK
I8为啥搜索功能用不了dd？而且更新之后电影板块哪里了	ASK
搜索功能用不了？dd而且更新之后电影板块去哪里	ASK
I8为啥搜索特性用不了？dd？而且更新之后电影有色去哪里了	ASK
搜索功能用不了？dd？更新之后电影去了	ASK
I8为啥搜索功能用不了？dd而且更新板块去了	ASK
I8为啥搜寻功能用不了？dd？而且更新之后恐怖片板块去哪里了	ASK
I8为什么搜寻功能用不了？dd？而且更新之后电影板块去哪里了	ASK
I8搜索功能用不了？dd？而且更新之后电影去哪里了	ASK
I8为什么搜索功能用不了？dd？而且更新之后电影金融股去哪里了	ASK
I8为啥搜寻基本功能用不了？dd？而且更新之后电影板块去哪里了	ASK
I8为啥功能用不了？？而且更新板块哪里了	ASK
I8为啥搜索功能用？dd？更新电影板块去哪里了	ASK
I8为啥搜索功能用不了而且更新之后电影板块去哪里了	ASK
I8为啥搜寻功能用不了？dd？而且更新之后电视剧板块去哪里了	ASK
I8为啥搜索功能用不了？而且更新之后电影板块去哪里了	ASK
I8搜索用dd？更新之后电影板块去哪里	ASK
I8为啥搜索功能用不了dd？而且更新之后板块去哪里了	ASK
I8为啥搜索功能用？dd？而且更新之后板块	ASK
I8为啥搜索功能用不了？dd？而且更新之后电影板块哪里了	ASK
估计也就小公司，才将狭小心胸寄托这种软件上，局限使用考勤功能	BF
估计也就制造业的小公司，才会将狭小胸襟寄托在这种开发工具上，局限使用考勤功能吧	BF
也就制造业小公司，才会将狭小心胸寄托在这种上，局限使用考勤吧	BF
估计也就服务业的小母公司，才会将狭小心胸寄托在这种软件上，局限使用考勤功能吧	BF
听音乐只用云村，这还用说吗？哈哈，只可惜新浪老婆不宠我，我玩玩的电子游戏也都是新浪的qvq非的要命，不过好是真的好啦	GF
只用云村，这？哈哈可惜网易爸爸不宠，我玩的也都的qvq的要命，不过好真的好啦	GF
听音乐云村，这吗？哈哈，只网易爸爸不宠我我玩的游戏也都是网易qvq非的要命，不过好是真的好啦	GF
听音乐只用云村，这还用说吗？哈哈，只可惜百度爷爷不宠我，我玩的游戏也都是百度的qvq非的可怕，不过好是难道好啦	GF
听音乐只用，这还用说吗？哈哈只可惜爸爸我，我玩的游戏也都网易的qvq非的要命，不过好是好啦	GF
辣鸡软件，APP投屏看电影都没问题，就腾讯视频无法投屏。浪费我的钱充	BF
辣鸡软件，其他QQ投屏看电影都没问题，就百度视频无法投屏。浪费我的钱充会员	BF
辣鸡软件，其他APP投屏看电影都没问题就视频无法投屏浪费我的钱充会员	BF
辣鸡软件，其他App投屏看该片都没问题，就腾讯视频无法投屏。浪费我的钱充会员	BF
不能用，点击更新后完全不能用，搞得现在我都不能用腾讯看书了，亏得我还支持了好久，小偷	BR
不能用，点击更新后完全不能用，搞得现在我都不能用网易看书了，亏得我还支持了好久，骗子	BR
不能用，点击更新后完全，搞得现在我都用腾讯看电视，亏得我还支持了这么久，骗子	BR
不能，点击更新后完全用，搞得现在都不能用了，亏得我还支持了，骗子	BR
不能用，点击更新后完全不能用，搞得现在我都不能用新浪睡觉了，亏得我还支持了多久，骗子	BR
不能用，点击更新后完全不能用，搞得现在我都不能用腾讯听歌了，亏得我还支持了好久，小偷	BR
不能用，点击更新后完全不能用，搞得现在我都不能用腾讯睡觉了，亏得我还支持了很久，小偷	BR
不能用，点击更新后完全不能用，搞得现在我都不能用网易看书了，亏得我还支持了很久，骗子	BR
不能用点击后完全不能用，搞得我都不能看电视了，亏得我还支持骗子	BR
注册可以下高清	GF
注册可以下高清音乐	GF
没法注册可以下高清音乐	GF
不用登记注册可以下高清音乐	GF
越更新越不好用昵称字符串不能修改了	BF
越更新越不好用昵称修改了	BF
越更新越不好用绰号字符不能修改了	BF
越更新越不好用昵称字符修改了	BF
进度条也太差按，无法正常快进快退啊。还有音画经常不同步是要闹哪样	BR
进度条也按无法正常快退啊。音画经常同步是要闹哪样	BR
也按，无法正常快进快退啊。音画经常不同步是闹哪样	BR
不好按，无法正常快退。还有音画经常不同步是闹哪样	BR
进度条也不好按，无法正常快进快退啊。音画经常不同步要闹哪样	BR
也不好按，无法快进快退。音画同步是要闹	BR
进度条也不太好按，无法正常快进快退啊。还有音画经常不同步是要闹哪样	BR
这次更新最垃圾，如果可以的版本就好了	BF
这次更新最垃圾，如果可以下会之前的版就好了	BF
更新最垃圾，可以下会之前版本就好了	BF
这次更新最垃圾，如果可以下之前的版本就好了	BF
这次更新最垃圾，可以下会之前的版本就好	BF
非常好用的APP，果断删除同类软件	GF
非常的app果断删除同类软件	GF
非常好用的App，果断删除同类软件	GF
非常果断删除同类软件	GF
非常好用的app，果断删除同类计算机系统	GF
垃圾，后点哪里都闪退，可惜我的会员，垃圾，真的烂居然能发出	BR
污水，更新版后点哪里都闪退，可惜我的会员了，污水，真的搞不懂这种烂版居然能收到来	BR
垃圾，更新后点都闪退可惜会员了，真的搞不懂这种版本居然能发出来	BR
垃圾，更新版后点哪里都闪退，可惜我的会员了，垃圾，呢搞不懂这种烂版居然能收到来	BR
垃圾，更新版本后点哪里都闪退，可惜我的了，垃圾，真的搞不懂这种烂能发出来	BR
垃圾，版本后点哪里都闪退，我的会员了，垃圾，搞不懂这种烂版本居然能发出来	BR
垃圾，更新版后点哪里都闪退，可惜我的会员了，垃圾，难道搞不懂这种烂版居然能收到来	BR
垃圾版本后点哪里都可惜我的会员了，，真的搞不懂这种版本居然能发出	BR
污水，更新版本后点哪里都闪退，可惜我的会员了，污水，实在搞不懂这种烂版本居然能收到来	BR
资源比较多，会员视觉效果清晰，挺喜欢的	GF
资源比较，会员画质清晰，挺喜欢的	GF
资源比较多，会员清晰度清晰，挺喜欢的	GF
比较多，会员画质清晰，挺喜欢的	GF
陈情令和庆余年都很好看，会一直支持视频和肖战。品牌方更是什么人，风波过去他还是那个最耀眼的男孩	GF
陈情令和庆余年都更好看，会一直支持腾讯视频和肖战。服装品牌方更清楚肖战是什么人，风波过去后他还是那个最耀眼的小男孩	GF
陈情令和庆三百多年都很好看，会一直支持腾讯截图和肖战。品牌方更清楚肖战是什么人，风波过去后他还是那个最夺目的男孩	GF
陈情令和庆余年都很好看，会一直支持腾讯录像和肖战。品牌方更清楚肖战是什么人，风波过去后他还是那个最夺目的女孩儿	GF
我的视频"页历史记录写成了"纪录"错字哦	BR
我的视频"页历史记录写成了"新纪录"错别字哦	BR
我的视频"历史记录写成了纪录"错别字	BR
视频"页了""错别字	BR
我的音频"页历史记录写成了"纪录"错别字哦	BR
我的视频"页历史记录写成了纪录错别字哦	BR
我的"历史记录写成了纪录"错别字	BR
我的视频"册历史记录写成了"纪录"错别字哦	BR
阿里巴巴公司出品，信息安全有确保，我们公司已经全部在用钉钉了	GF
出品，信息安全有保障，已经在用钉钉了	GF
阿里巴巴出品，网络安全有保障，我们母公司已经全部在用钉钉了	GF
阿里巴巴出品，信息安全有保障我们公司已经全部在用钉钉了	GF
钉钉对于工作者而言，程度的节省了劳动力，我们家远的，可以钉钉会议的形式，进行开会，随时随地都开会，都可以交流，这也了同事间的友谊	GF
钉钉对于工作者而言，极大程度的节约了劳力，我们家远的，也可以通过钉钉会议的形式，进行开会讨论，随时随地都可以开会讨论，都可以交流，这也促进了同事间的情谊	GF
钉钉对于工作者而言，极大程度的节省时间了劳力，我们家远的，也可以通过钉钉会议的方式，进行开会，随时随地都可以开会，都可以交流，这也促进了同事之间的友谊	GF
钉钉对于工作者而言，极大程度的节省了劳力，我们家远的，也可以通过钉钉会议的形式，进行开会，随时随地都可以开会，都可以交流活动，这也促进了同事之间的友好关系	GF
钉钉对于工作者，程度的了劳动力，我们家远的，也可以通过钉钉会议的，进行开会，随时随地都开会，都可以交流，这也促进了同事间的友谊	GF
希望有些歌能争取到版权，出钱也没关系的，嘻嘻	ADV
希望有些争取版权，花钱也没关系的，嘻嘻	ADV
希望有些争取到版权花钱没关系的嘻嘻	ADV
希望有些歌能争取到版权，也没关系，嘻嘻	ADV
有些歌能到版权花钱也的，嘻嘻	ADV
有些歌能争取到版权，花钱没关系的，	ADV
期望有些歌能争取到版权，花钱也没关系的，嘻嘻	ADV
还极好，挺好用的，方便的很	GF
还不错，挺好用的，的很	GF
还上佳，挺好用的，方便的很	GF
还不错，方便很	GF
作为一个四川人，我想要说的是，支付宝。巴适	GF
作为一个四川人，我想说，支付宝。巴适	GF
作为一个四川人，我想说道的是，支付宝。巴适	GF
作为一个四川人，我说的是，支付宝。巴适	GF
特别喜欢，还可以看评论，互动感十足	GF
特别喜欢，听歌还可以看评论，互动感极富	GF
特别喜欢，听歌还可以看，互动感十足	GF
愈升级愈垃圾，转账麻烦死，微信都做起来了，用了你这么久从没这么差过。脑残设计师	BF
越升级越垃圾，转账麻烦病死，微信都做起来了，用了你多久从来没这么差过。脑残设计师	BF
越升级越，转账麻烦做起来了，用了你这么久从来没这么差过。脑残	BF
越升级越垃圾，转账麻烦死微信做起来了，用了你从来没这么差过设计师	BF
越升级越垃圾，转账麻烦死，微信都做起来了，用了你好久从没这么差过。脑残设计师	BF
以前那个版挺好的昂，更新要考虑用户习惯，别成为第二个京东，大小操作不方便	ADV
以前那个标准版挺好的昂，更新要考虑用户习惯，别成为第四个腾讯，大小操作不方便	ADV
以前那个版本挺好的昂，更新要考虑用户生活习惯，别成为第十个腾讯，大小操作不方便	ADV
以前版本挺好的昂，更新考虑用户习惯，第二个腾讯，大小操作不方便	ADV
以前那个版本昂，考虑用户，第二个腾讯，大小不方便	ADV
以前那个的昂，更新要用户习惯，别第二个腾讯，大小操作不方便	ADV
以前那个版本，更新要考虑用户习惯，别成为第二个腾讯，大小操作不方便	ADV
以前版本挺好的昂，更新要用户，别第二个腾讯，操作不方便	ADV
以前那个版本挺好的昂，更新要考虑用户生活习惯，别成为第二个UC，大小操作不方便	ADV
工作方便多了，审批也更快	GF
工作方便多了，审批程序流程也更快	GF
工作方便多了，审批程序也更快	GF
方便，流程更快	GF
苹果，下不了，怎么办	ASK
谷歌ig6，下不了，的怎么办	ASK
亚马逊ig6，下不了，的怎么办	ASK
小米ig6，下不了，的怎么办	ASK
ig6下不了，	ASK
诺基亚ig6，下不了，的怎么办	ASK
苹果公司ig6，下不了，的怎么办	ASK
微软ig6，下不了，的怎么办	ASK
iPadig6，下不了，的怎么办	ASK
苹果，下不了，的怎么办	ASK
ig6，下不了，怎么办	ASK
苹果ig6，下不了的怎么办	ASK
下不了的	ASK
苹果ig6，不了，的怎么办	ASK
ig6，下不了，的怎么办	ASK
苹果不了，的怎么办	ASK
，下，的怎么办	ASK
苹果ig6下不了，怎么办	ASK
iPhoneig6，下不了，的怎么办	ASK
苹果ig6不了，的怎么办	ASK
苹果ig6，，	ASK
，公司，企业集团，用这个软件非常适合强烈推荐	GF
个人，公司，企业，控股，用这个软件非常适合，强烈推荐	GF
个人公司，企业，集团，用这个软件非常适合，强烈推荐	GF
个人，母公司，企业，集团，用这个软件非常适合，强烈推荐	GF
个人，公司，企业，股份公司，用这个软件非常适合，强烈推荐	GF
用手机的时候，总是跳转到软件，不知道为什么	BR
用支付宝笔记本电脑支付的时候，总是跳转到另一款应用程序上，不知道为什么	BR
用支付宝手机缴付的时候，总是重定向到另一款软件上，不知道为什么	BR
用支付宝手机支付的时候，跳转另一款上，不知道为什么	BR
用网银手机缴付的时候，总是跳转到另一款软件上，不知道为什么	BR
用支付宝支付的时候，总是跳转到另一款知道为什么	BR
用支付宝iPhone4缴付的时候，总是跳转到另一款软件上，不知道为什么	BR
用银联手机支付的时候，总是跳转到另一款应用软件上，不知道为什么	BR
什么都好，就是的我的借呗怎么就是不能用	BF
什么都好，就是tm的我借呗怎么就是不能用	BF
上下班，再也担心，报销，方便，最好的软件没有之一	GF
上下班自动打卡，再也担心忘了，报销，越来越方便，最好的软件没有之一	GF
上班手动打卡，再也不用担心忘打卡了，审批报销，越来越方便，最好的办公软件没有之一	GF
上下班手动打卡，再也不用担心忘打卡了，审批报销，越来越方便，最好的办公计算机系统没有之一	GF
督促每天运动量不久坐，的	GF
督促每天的训练量，不久坐，挺好的	GF
督促每天的活动量，不久坐，挺好的	GF
督促每天的食量，不久坐，挺好的	GF
督促每天的运动量不久，挺好的	GF
微信后台收不到就算了打开微信消息，就收不到接下来的消息重新才能收到，为什么	BR
QQ后台运行收不到就算了，开启QQ收到消息，就收不到接下来的消息必须重新开启才能收到，为什么	BR
微信后台运行收不到就算了，微信收到消息，就收不到接下来消息打开才能收到，为什么	BR
后台运行收不到了，微信收到，就收不到接下来消息必须重新打开才能收到，	BR
微信后台运转收不到就算了，打开微信发出消息，就收不到接下来的消息必须重新打开才能发出，为什么	BR
QQ后台运行收不到就算了，打开QQ收到最新消息，就收不到接下来的最新消息必须重新打开才能收到，为什么	BR
微信后台运行了，微信收到，就收不到接下来的消息必须重新打开收到，为什么	BR
微信后台运行收不到就算了，打开微信接获最新消息，就收不到接下来的最新消息必须重新打开才能接获，为什么	BR
微信后台运行收不到了，打开微信收到消息，就接下来的消息必须重新打开，	BR
wx什么都挺好的，就是发视频权限不太好，可以不设置权限，我觉得如果发长视频就完美了	ADV
wx什么都挺好的，就是发朋友圈视频不太好，不设置权限，我如果可以发长视频真的就完美了	ADV
wx什么都挺好的，就是发朋友圈视频权限不是太好，可以不设置权限，我觉得如果可以发宽视频呢就完美了	ADV
wx什么都挺好的，就是发朋友圈视频职权不好，可以不设置职权，我觉得如果可以发长视频难道就完美了	ADV
wx什么都挺好的，就是发朋友圈录像权限不是太好，可以不设置权限，我觉得如果可以发短录像真的就完美了	ADV
wx什么都挺好的，就是发朋友圈视频职权不太好，可以不增设职权，我觉得如果可以发长视频实在就完美了	ADV
wx什么都挺好的，就是朋友圈视频权限，可以不设置权限，我如果发长真的完美了	ADV
wx什么都挺好的，就是发朋友圈音频权限不是太好，可以不设置权限，我觉得如果可以发长音频吗就完美了	ADV
wx什么都挺好的，就是发朋友圈录像职权不太好，可以不设置职权，我觉得如果可以发宽录像真的就完美了	ADV
每天全用手机。很	GF
每天上下班都省却了指模打卡。全用手机。很方便	GF
每天上下班都省去了指模打卡。全用手机。很	GF
每天上下班省去了指模。手机。方便	GF
每天上下班都省去了指模打卡。全用电脑。很方便	GF
不是标题和对不上就是胡乱剪辑的视频，腾讯视频半点观赏价值没有	BF
不是标题和内容对不上，就是胡乱剪辑的音频，新浪音频内容半点观赏价值没有	BF
不是标题和就是胡乱剪辑的视频腾讯内容半点没有	BF
不是标题和对不上，就是胡乱剪辑的视频，腾讯视频内容半点	BF
不是标题和内容对不上，就是胡乱剪接的视频，阿里巴巴视频内容半点观赏价值没有	BF
通用审批通过后如何按关键字进行搜索	ASK
通用审批通过后如何按审批内容字串进行搜索	ASK
通用核准通过后如何按核准内容关键字进行搜索	ASK
通用审批通过后如何审批关键字进行	ASK
通用审批通过后如何按审批内容关键字进行搜寻	ASK
审批通过后如何按审批内容进行搜索	ASK
通用通过后如何按审批内容关键字进行搜索	ASK
通用审批通过后如何审批内容关键字搜索	ASK
通用审批通过如何按审批关键字进行搜索	ASK
通用审批通过后如何按审批内容URL进行搜索	ASK
通用审批通过后如何审批内容关键字进行搜索	ASK
通用审批通过后按审批关键字进行搜索	ASK
通用审批程序通过后如何按审批程序内容关键字进行搜索	ASK
通用审批通过如何按审批内容关键字进行搜索	ASK
通用审批通过按审批内容关键字	ASK
通用审批通过后按审批内容关键字进行	ASK
通用审批通过后如何按审批内容语句进行搜索	ASK
通用审批通过后如何按审批内容关键字搜索	ASK
通过后如何按审批内容关键字进行搜索	ASK
最近蚂蚁宝卡针对钉钉免流量了，所以配备来聊天，感觉很上佳呢	GF
最近蚂蚁宝卡针对钉钉免流量了，所以放置来聊天，感觉很不俗呢	GF
最近蚂蚁宝卡针对钉钉免流量了，所以放置来聊天，感觉很很棒呢	GF
看着看着网就断。App都能上就视频，有毒啊还我电视剧都看过瘾	BR
失望，看着看着网就断了。别的能连上，就腾讯视频连不上，有毒啊。还我看个电视剧都看不	BR
沮丧，看着看着网就断了。别的App都能连上，就腾讯音频连不上，有毒啊。还我看个剧都看不过瘾	BR
失望，看著看著网就断了。别的App都能连上，就新浪录像连不上，有毒啊。还我看个电视剧都看不过瘾	BR
讶异，看着看着网就断了。别的App都能连上，就网易视频连不上，有害啊。还我看个电视剧都看不过瘾	BR
失望，看着了。别的App都能连上，腾讯，有毒啊还我看个电视剧都看不	BR
沮丧，看着看着网就断了。别的APP都能连上，就阿里巴巴视频连不上，有毒啊。还我看个电视剧都看不过瘾	BR
，看着看着网就断了。别的App都连上，就腾讯视频连不上，有毒啊。我看个看不	BR
失望看着看着网就断了。App都能连，就腾讯视频连不上有毒啊。还我看个电视剧都看过瘾	BR
难过，看着看着网就断了。别的iOS都能连上，就腾讯视频连不上，有毒啊。还我看个连续剧都看不过瘾	BR
视频比较多，比爱奇艺免费的多	GF
视频比较多，比爱奇艺免费的影片多	GF
视频比较，奇艺免费的片子	GF
音频比较多，比爱奇艺免费的片子多	GF
办公交流活动利器，非常好用;但隐私权在企业里变的随意，对以后隐私权情况堪忧	BF
，非常;但个人隐私在企业里变的随意，对个人隐私情况堪忧	BF
办公交流法宝，非常好用;但个人隐私在企业里变的随便，对以后个人隐私情况堪忧	BF
办公交流利器，好用;但个人隐私在企业里变的随意以后个人隐私	BF
什么支付宝。绑定了什么都改不了，被别人冒用了都不知道。一分钱被盗了也不知道找谁赔。废物	BF
什么支付宝。绑定了都改不了，被盗用了都知道。钱被盗了不找谁赔垃圾	BF
什么支付宝绑定了什么改不了，被盗用了都知道。也知道找谁赔垃圾	BF
什么支付宝。存取了什么都改不了，被别人冒用了都不知道。银子被盗了也不知道找谁赔。垃圾	BF
最新有问题，无法登陆，只能手机号登陆，选择其他方式	BR
最新系统有问题，无法登陆，就可以手机号登陆，无法选择其他手段	BR
最新系统有问题，无法，只能手机号，选择其他方式	BR
最新模块有问题，无法登陆，只能手机号登陆，无法选择其他方法	BR
最新系统问题，无法登陆，只能登陆，无法选择其他方式	BR
最新系统有问题，无法登陆，只能电话号码登陆，无法选择其他形式	BR
最新控制系统有问题，无法登陆，就可以手机号登陆，无法选择其他方式	BR
下一希望适配暗黑	ADV
下一版本希望适配暗黑方式	ADV
下一版本希望适配暗黑	ADV
下希望模式	ADV
下一标准版希望适配暗黑模式	ADV
下一版本希望适配暗影模式	ADV
下一版本希望暗黑	ADV
很好用的计算机系统，界面很喜欢，唯一的不足就是版权太少，很多歌听到不了	ADV
很好用的软件，很喜欢，的不足就是少很多歌听不了	ADV
很好用的，很喜欢的不足就是版权太少，很多歌听不了	ADV
很好用的软件，界面很偏爱，唯一的不足就是改编权太少，很多歌听不了	ADV
很好用的插件，快捷键很喜欢，唯一的不足就是版权太少，很多歌听不了	ADV
用的软件，界面喜欢，唯一不足就是版权太少，很多歌听不了	ADV
用的软件，界面喜欢，唯一不足就是版权太很多歌听	ADV
很好用的软件，介面很喜欢，唯一的不足就是版税太少，很多歌听不了	ADV
不能屏蔽微信，这么简单的功能也做不到吗？不能屏蔽微信这么简单的功能做不到吗？不能微信，这么简单的功能也做不到吗	ASK
不能过滤QQ群，这么非常简单的机能也做不到吗？不能过滤QQ群，这么非常简单的机能也做不到吗？不能过滤QQ群，这么非常简单的机能也做不到吗	ASK
不能微信，这么的功能做不到吗？不能屏蔽微信群，这么简单的功能也做不到吗？不能群，这么简单的也做吗	ASK
不能过滤QQ群，这么简便的特性也做不到吗？不能过滤QQ群，这么简便的特性也做不到吗？不能过滤QQ群，这么简便的特性也做不到吗	ASK
不能过滤QQ群，这么非常简单的特性也做不到吗？不能过滤QQ群，这么非常简单的特性也做不到吗？不能过滤QQ群，这么非常简单的特性也做不到吗	ASK
屏蔽微信群，这么简单功能做不到吗？不能屏蔽群，简单的功能也做不到？不能屏蔽微信群这么简单的功能不到吗	ASK
屏蔽微信群，这么简单的功能也不到吗？不能屏蔽群，这么简单的功能做不到吗？不能微信群，简单的也做不到吗	ASK
不能过滤QQ群，这么单纯的系统也做不到吗？不能过滤QQ群，这么单纯的系统也做不到吗？不能过滤QQ群，这么单纯的系统也做不到吗	ASK
屏蔽群简单的也做吗？微信群，这么简单的功能也做不到屏蔽微信群，简单功能也做不到吗	ASK
屏蔽微信群，这么简单的功能也做不到？不能屏蔽微信，这么简单功能做不到吗？不能屏蔽微信，这么简单功能也做不到	ASK
不能过滤QQ群，这么单纯的特性也做不到吗？不能过滤QQ群，这么单纯的特性也做不到吗？不能过滤QQ群，这么单纯的特性也做不到吗	ASK
不能屏蔽微信群，这么简单也做不到吗？不能屏蔽微信群，这么简单的功能也做不到？不能屏蔽群，这么简单也做吗	ASK
不能过滤QQ群，这么简便的基本功能也做不到吗？不能过滤QQ群，这么简便的基本功能也做不到吗？不能过滤QQ群，这么简便的基本功能也做不到吗	ASK
屏蔽，这么简单的功能也做不到吗？不能屏蔽微信群，这么简单的功能也做不到吗？不能屏蔽微信群，这么简单的也做不到吗	ASK
不能过滤QQ群，这么直观的机能也做不到吗？不能过滤QQ群，这么直观的机能也做不到吗？不能过滤QQ群，这么直观的机能也做不到吗	ASK
不能屏蔽微信群，这么简单的功能也不到屏蔽微信群，这么简单的功能也做？屏蔽微信，的功能也做不到	ASK
不能过滤QQ群，这么直观的基本功能也做不到吗？不能过滤QQ群，这么直观的基本功能也做不到吗？不能过滤QQ群，这么直观的基本功能也做不到吗	ASK
不能屏蔽群，这么简单功能也做不到？不能屏蔽微信群，这么简单的功能也做不到吗？不能屏蔽微信群，这么功能也做不到吗	ASK
不能微信群这么功能也做不到吗？不能屏蔽微信群简单也做吗？不能屏蔽微信群这么简单的功能也做不到吗	ASK
不能过滤QQ群，这么单纯的机能也做不到吗？不能过滤QQ群，这么单纯的机能也做不到吗？不能过滤QQ群，这么单纯的机能也做不到吗	ASK
不能屏蔽微信群，这么简单功能做不到吗不能屏蔽微信群，简单的功能也做不到吗？不能屏蔽群，简单也不到	ASK
不能微信群，简单的功能做不到吗？不能屏蔽微信群这么简单的功能做不到吗不能屏蔽微信群，这么的也做不到吗	ASK
不能过滤QQ群，这么非常简单的基本功能也做不到吗？不能过滤QQ群，这么非常简单的基本功能也做不到吗？不能过滤QQ群，这么非常简单的基本功能也做不到吗	ASK
屏蔽微信群，也做不到吗屏蔽微信群，这么的功能也做不到吗？不能屏蔽微信群，这么简单的功能也做不到吗	ASK
不能微信群，简单的功能也不到吗？不能屏蔽微信群，简单的功能也吗？不能屏蔽微信群，简单的功能也做不到吗	ASK
不能屏蔽群，这么简单的功能也做不到？不能屏蔽微信群，这么简单的功能？屏蔽群，这么做吗	ASK
屏蔽群，这么简单的功能也做吗？不能屏蔽微信群，简单的也不到吗？不能屏蔽微信群，的功能也做不到吗	ASK
不能微信群，这么简单的功能也做不到吗？不能屏蔽微信群这么简单的功能也做吗？屏蔽群这么简单的功能做吗	ASK
不能屏蔽微信群，这么简单的功能也做不到吗不能微信群，这么简单的功能也做不到吗？不能屏蔽微信，这么简单的也做不到吗	ASK
不能群这么也吗？屏蔽微信群这么简单的功能也不到吗？不能屏蔽微信群，的功能也做不到吗	ASK
到了支付页面就的选择银行卡，明明绑定叻了，为毛没有，现在根本无法用支付宝	BR
到了页面的选择银行卡明明叻银行卡了啊，为毛没有选项，现在根本无法用支付宝付款昂	BR
到了缴付首页就毛线的选择银行卡，明明绑定叻银行卡了啊，为毛没有选项，现在根本无法用支付宝收款了昂	BR
到了缴付页面就毛线的选择银行卡，明明存取叻银行卡了啊，为毛没有选项，现在根本无法用京东付款了昂	BR
到了支付页面就毛线的选择钱包，明明存取叻钱包了啊，为毛没有选项，现在根本无法用支付宝下单了昂	BR
到了支付页面就毛线的选择钱包，明明绑定叻钱包了啊，为毛没有选项，现在没法用支付宝结账了昂	BR
到了缴付app就毛线的选择银行卡，明明绑定叻银行卡了啊，为毛没有选项，现在根本无法用支付宝退款了昂	BR
到了支付关键字就毛线的选择手机卡，明明绑定叻手机卡了啊，为毛没有选项，现在根本无法用支付宝结账了昂	BR
到了支付毛线的选择银行卡，明明绑定叻了，毛没有选项，现在根本无法用支付宝付款了昂	BR
到支付页面就毛线选择银行卡，明明绑定叻银行卡了啊，毛没有选项，现在根本无法用付款了昂	BR
希望下次更新能有后台或者播放语音条的	ADV
希望下次更新能有后台或者浮窗重播语音条的功能	ADV
下次更新能有后台浮窗播放条功能	ADV
希望下次更新能有后台或者浮窗拨放语音条的功能	ADV
希望下次能有播放语音条的	ADV
希望下次更新能有后台或者浮窗播放语音两条的功能	ADV
希望下次更新能有后台或者浮窗播映语音条的功能	ADV
，就是转账金额太少只有万，如果到100好了	BF
好用，就是转账投资金额太太少，只有20万，如果可以到100就好了	BF
好用，就是转账金额太，只有20万，如果可以到100就了	BF
软件更新不了，下载还下载不起，说什么软件更新起了冲突，想爆粗口了	BF
软件软件更新不了，删了重新点播还点播不起了，说什么软件更新起了冲突，真的想要爆粗口了	BF
软件更新不了，删了重新还下载不起了，说什么软件更新起了冲突，真的想爆粗口	BF
很好用，如果可以连淘宝了	ADV
更好用，如果直接可以连淘宝就更好了	ADV
，如果直接可以连淘宝就更好	ADV
极好用，如果直接可以连淘宝就更好了	ADV
很好用，如果可以连淘宝就更好了	ADV
很好用，如果直接可以连淘宝就更多了	ADV
很好用，如果直接可以连天猫就更好了	ADV
很好用如果直接连淘宝就更好了	ADV
很好用，如果直接可以连就更好了	ADV
十分感谢，找了很久了，憧憬高品质无损版	ADV
十分非常感谢，找了很久了，期待高品质无损版	ADV
感谢，找了很久了，无损	ADV
十分感谢，找了很久，期待高品质版	ADV
十分谢谢，找了很久了，期待高品质无损版	ADV
十分表示感谢，找了很久了，期待高品质无损版	ADV
十分感谢了久了，期待高品质无损版	ADV
十分，找了很久了高品质无损版	ADV
十分感谢，找了很久了，期盼高品质无损版	ADV
我唯一卖的会员，很好用	GF
唯一买的会员，很好用	GF
我惟一买的会员，很好用	GF
办公软件，你值得具有，做得很好	GF
办公应用程序，你值得拥有，做得很好	GF
办公软体，你值得拥有，做得很好	GF
办公，值得拥有，做得	GF
很多之前听过偏门的舞蹈都能寻得，很开心，也能推荐很好听的冷门舞蹈	GF
很多之前听过偏门的音乐都能找到，开心，也推荐很好听的冷门音乐	GF
很多之前听过偏门的流行乐都能找到，很开心，也能推荐很好听到的冷门流行乐	GF
很多之前听过偏门的音乐都能找到，很兴奋，也能推荐很好听到的冷门音乐	GF
我抑郁症，对一些细节比较注重，总体对钉钉，是非常的讨厌	GF
我强迫症，对一些细节比较注重，总体对钉钉是非常的喜欢	GF
我，对一些细节比较注重，总体对钉钉是非常的喜欢	GF
我癫痫，对一些细节比较侧重，总体对钉钉，是非常的喜欢	GF
可以看见很多欧美音乐。很难找的音乐都可以在搜狗云音乐找到。非常棒	GF
可以听到欧美音乐找的音乐都可以在网易云音乐找到。棒	GF
可以听到很多欧美音乐。很难找的电子音乐都可以在网易云电子音乐看到。非常棒	GF
可以说出很多欧美音乐。很难找的音乐都可以在网易云音乐找寻。非常棒	GF
好的app	GF
非常好的一款，	GF
非常好的一款app，	GF
非常好的一款App，支持	GF
后台关掉重开app才能声音	BR
必须后台关掉重开APP才能出声音	BR
必须后台关掉重开app才能出嗓音	BR
必须后台关掉重开app才能声音	BR
后台关掉重开app才能出声音	BR
自从用了网易云以来，就再也没用过其他的舞蹈软件。网易云简直如同我心里的蛔虫期望，每天的每周推荐总是让我心头一颤。我的舞蹈格调也因为网易云从最开始的盛行到古风到流行乐再到最后的电音。呢自从用了网易云我的手臂都不会正经放了，一刻不抖就感觉不正常了	GF
用了网易云以来，就再也没用过其他的音乐软件。网易简直如同心里的蛔虫希望，每天的每日推荐总是让我心头。我的音乐品味也网易从最开始的流行到古风到民谣再到最后的电音真的自从了网易的腿都不会正经放了，一刻就正常了	GF
自从用了网易和云以来，就再也没用过其他的音乐软件。网易和云简直如同我心里的蛔虫期望，每天的每日推荐总是让我心头一颤。我的音乐魅力也因为网易和云从最开始的流行起来到古风到童谣再到最后的流行乐。难道自从用了网易和云我的大腿都不会正经放了，一刻不抖就感觉不正常了	GF
用了网易以来，再也没用过其他的音乐软件。网易云简直如同心里的蛔虫希望，的每日总是让一颤。的音乐品味也网易从最的流行到古风到民谣再到的。自从网易我的腿都不会正经放了一刻不抖就感觉不正常了	GF
随时随地办公，非常好的和同事协同办公	GF
随时随地，非常好的和同事办公	GF
随时随地办公，非常好的和同事协调办公	GF
功能不要有点多，界面有点臃肿	ADV
功能，界面太臃肿	ADV
功能不要实在太多，界面实在太臃肿	ADV
功能太多，界面太臃肿	ADV
功能不要过于多，界面过于臃肿	ADV
功能不要太，界面太	ADV
功能不要太多，快捷键太臃肿	ADV
功能不要这么多，界面这么臃肿	ADV
网页只能试看5分钟，Store登陆闪退，还我一年会费	BR
网页就可以试看5分钟，App登陆闪退，还我一年会费	BR
网页只能试看分钟，App登陆闪退，还我一年会费	BR
网页只能试看分钟，登陆闪退，还我一年会费	BR
网页只能试看5分钟，IOS登陆闪退，还我一年会费	BR
网页只能试看5分钟，App登陆还我一年会费	BR
网页只能5分钟，App登陆闪退，我一年会费	BR
5分钟，App闪退，还我会费	BR
网页只能试看5三分钟，App登陆闪退，还我一年会费	BR
网页只能试看5分钟，App登陆闪退，还我会费	BR
网页只能试看5分钟，Safari登陆闪退，还我一年会费	BR
希望长截图	ADV
期望推出长截图功能	ADV
希望推出长图片功能	ADV
推出长截图功能	ADV
希望推出截图功能	ADV
希望推出宽截图功能	ADV
希望推出长截图基本功能	ADV
支付密码忘掉了。按提示从新增设了，可就是不正确	BR
支付密码忘记了按提示从新设置了，可就是不正确	BR
缴付密码忘记了。按提示从崭新设置了，可就是不正确	BR
支付密钥忘记了。按提示从新增设了，可就是不正确	BR
支付忘记。按提示从新可不正确	BR
密码忘记了按提示从新了，不	BR
支付密码想到了。按提示从新设了，可就是不正确	BR
支付了。按提示从新设置，可正确	BR
支付密码忘记了。按提示新设置了可就是不正确	BR
密码了按提示从新设置了，就是不正确	BR
推荐的歌单都很智能而且个性化。亮点在于评论，有时候听着歌看评论都能看一个多小时。在这里，你能看到他人一样在路上，一个有分野的共鸣，引导你安慰你	GF
推荐的歌单都很智能而且个人化。亮点在于影评，有时候听到着歌看影评都能看好几个秒钟。在这里，你能看到他人一样在路边，一种有差异的共鸣，鼓励你恳求你	GF
的歌单都很智能而且个人化。在于评论，有时候着能好几个小时。在这里，你能他人一样路上一种有差异的共鸣，鼓励安慰你	GF
推荐的歌单都智能在于评论，有时候听歌看评论都好几个小时。在这里，你能看到他人一样在路上，一种有差异共鸣，鼓励你安慰你	GF
闪退的各位大哥们。好累心。一遍遍闪。爱网易音乐啊我也很绝望	BR
闪退啊我的各位核心技术大哥们。好累心。一遍遍闪。不是恶意影评。我爱腾讯音乐啊。我也很绝望	BR
我的技术。好累心。一遍。不是评论。我网易啊。也很绝望	BR
闪退啊我的各位技术大哥们好累心。一遍遍闪。不是恶意评论。爱音乐啊。我也很绝望	BR
闪退啊我的各位技术大哥们。好累心。一遍遍闪。不是蓄意评论。我爱搜狗摇滚音乐啊。我也很绝望	BR
闪退啊我各位技术大哥们。好累心。遍闪。不是恶意评论我爱网易音乐。我也很绝望	BR
闪退啊我的各位技术大哥们好累心。一遍遍闪。不是评论我爱网易音乐啊。也绝望	BR
闪退我的各位大哥们心遍闪。不是恶意评论。我音乐啊。我也很	BR
闪退啊我的各位技术大哥们。好累心。一遍遍闪。不是蓄意文章。我爱新浪音乐啊。我也很绝望	BR
闪退啊我的各位控制技术大哥们。好累心。一遍遍闪。不是恶意评论。我爱网易现代舞啊。我也很恐惧	BR
很好的应用程序，很实用。我想，离不开它了	GF
很好的软件，很新颖。我想，离不开它了	GF
的软件，实用。想，它了	GF
很好的软件，很实用我，离不开它了	GF
很好的软体，很实用。我想，离不开它了	GF
我目前买东西，车票用花呗转账到账快不收，存入余额能挣钱真心越用越爽快，赞一百个的	GF
目前买，车票，转账到账快，不收手续费，存入余额宝还能挣钱真心越用越爽快，一百个的	GF
我目前买东西，车票用花呗，转账到账快，不收手续费，零钱存入余额宝还能养活，真诚越用愈爽快，赞一百个的	GF
我目前买东西，火车票用花呗，转账到账快，不收手续费，零钱存入余额宝还能养活，真心越用越爽快，赞五十个的	GF
我目前买东西，车票用花呗，提款到账快，不收手续费，零钱存入余额宝还能挣钱，真诚越用越爽快，盛赞一百个的	GF
真的很污水，打不上卡有时候。系统繁忙。客服人员界面打不开别的都可以	BF
真的很垃圾，打不上卡有时候系统繁忙。客服界面打不开别的	BF
真的很，打不上卡有时候系统繁忙。客服打不开都可以	BF
真的很垃圾，打不上卡有时候。控制系统繁忙。客服人员界面打不开别的都可以	BF
在用，很方便。信用可以与更多的领域联系，大家带来方便马云	GF
在用，很方便芝麻信用还可以与更多的领域联系给大家带来方便。加油马云哥	GF
一直在用，很方便。葱信用还可以与更多的应用领域联系，给大家产生方便。加油马云哥	GF
一直在，很方便。芝麻信用还与更多领域联系，给大家带来方便。马云哥	GF
一直在用，很方便。葱信用还可以与更多的领域联系，给大家增添方便。助威马云哥	GF
1是回拨电话。2没有拨号键盘。3:淘宝习惯性5星	BF
1:是拨电话。2没有拨号键盘。3:购物5星	BF
1:是回拨电话。2:没有拨号音箱。3:淘宝购物习惯性5星在	BF
1:是回来拨电话。2:没有拨号鼠标。3:淘宝购物习惯性5星	BF
1:是回2:拨号键盘。3:淘宝习惯性5星	BF
真心是从未用过比视频更垃圾的视频播放软件了，说会员会员，下载视频还要卡顿，恶心到极致	BF
真心从未用过比网易视频更垃圾的视频播放软件了，不说会员不会员，下载的视频还要卡顿，呼吸困难到极致	BF
真心是从比视频更垃圾的视频不说不会员，下载还要卡顿，恶心到极致	BF
真诚是从未用过比UC视频更垃圾的视频播放软件了，不说会员不会员，点播的视频还要卡顿，恶心到极致	BF
真心是从未用过比腾讯视频更垃圾视频播放，不会员不会员，视频卡顿，恶心到极致	BF
非常好的娱乐。集文化传媒游戏于一体，直播笑话乐大家。一款非常好的App，我喜欢	GF
非常好娱乐。集影视一体，直播笑话乐大家一款非常，我喜欢	GF
非常好的娱乐。集影视游戏于一体，直播笑话乐大家。好的，我喜欢	GF
非常好的娱乐。六集影视游戏于一体，直播笑话乐大家。一款非常好的app，我讨厌	GF
非常方便转账不	GF
非常方便，转账不需要	GF
非常方便，转账不需要保证金	GF
非常方便，转账不需要佣金	GF
要是取消了手势密码基本功能，那一点个人信息都没有了。账户里面多少钱别人随时都知道。要是真的取消了，支付宝里面一分钱都不敢放了	BF
要是取消了手势密码功能，那一点隐私都没有了。账户里边多少钱别人随时都知道。要是实在取消了，PayPal里边一分钱都不敢放了	BF
要是取消手势密码，那一点隐私都没有了。账户多少钱别人随时知道。要是取消了，支付宝一分钱都不敢放了	BF
取消了手势密码那一点隐私都没有了。账户多少钱别人随时都知道。要是真的取消了，支付宝里一分钱都不敢放了	BF
一颗星的不满足是QQ号不能变更。当年我年少无知设置的QQ号呀	BF
一颗星的不是微信号不能更改。当年我年少无知设置的号	BF
一颗星的不满足是微信号不能当年我年少无知设置的呀	BF
颗星的不满足是QQ号不能更改。当年我年少无知设置的QQ号呀	BF
这是一捆很好软件，赞	GF
很好的软件，赞	GF
这是一捆很好的SNS软件，赞	GF
这是很好的社交软件，赞	GF
这是一捆很好的社交硬件，赞	GF
我都用它听电子乐，感觉比了。什么是，什么是音乐层次不一样	GF
我都用它听电子乐，感觉比其他软件强多了。什么是歌曲，什么是摇滚音乐，层级不一样	GF
我都用它听到电子乐，感觉比其他软件强多了。什么是名曲，什么是音乐，层次不一样	GF
我用它听电子乐感觉比其他软件强多了。什么是，什么是音乐，层次不一样	GF
通用功能已很强大，重OA	GF
功能很强大，轻	GF
通用功能很强大，轻OA	GF
用了挺了，感觉推荐很符合的胃口，感觉很棒	GF
用了久了，感觉的也很符合的胃口，总体感觉很棒	GF
用了挺久了，感觉推荐的也很符合中国自己的胃口，整体感觉很棒	GF
用了挺久了，感觉推荐的也很合乎自己的胃口，整体感觉很棒	GF
微信密码通过申诉后，然后要更改密码，更改不了。为什么。社会公众号没有一个答复的。有什么用	BR
微信申诉，要修改密码，修改不了。。公众号没有一个。有	BR
密码申诉后，然后要修改，修改不了。为什么。公众号一个回复的。什么用	BR
微信密码通过申诉后然后要修改密码，不了。为什么。公众号没有回复的。什么用	BR
微信密钥通过申诉后，然后要修改密钥，修改不了。为什么。社会公众号没有一个答复的。有什么用	BR
微信通过申诉后，然后要修改密码，。为什么。公众号没有回复。有什么用	BR
QQ密钥通过申诉后，然后要改动密钥，改动不了。为什么。公众号没有一个回复的。有什么用	BR
QQ密码通过申诉后，然后要修订密码，修订不了。为什么。社会公众号没有一个回复的。有什么用	BR
苹果6刷朋友圈卡顿帧望优化	BR
苹果6刷朋友圈卡顿掉字节，望优化	BR
苹果6刷朋友圈卡顿掉，望优化	BR
iPhone6刷朋友圈卡顿掉帧，望优化	BR
苹果6刷朋友圈卡顿掉帧，望强化	BR
苹果6朋友圈卡顿掉帧，望优化	BR
苹果6朋友圈卡顿掉帧	BR
亚马逊6刷朋友圈卡顿掉帧，望优化	BR
苹果卡顿掉望优化	BR
无法跟崭新，连旧版也无法用，删除后也无法架设，造成非常不便，望尽快解决	BR
无法跟崭新，连旧版本也无法用，删除后也无法安装，造成非常不便，望尽快解决	BR
无法新，旧版也无法，删除后也无法安装，非常不便，望尽快解决	BR
无法跟新，连旧版本也无法用，删除后也无法安装，造成非常不便，望尽快妥善解决	BR
无法，连旧版也无法用，无法安装，造成不便，望尽快解决	BR
无法跟崭新，连旧版也无法用，删去后也无法安装，造成非常不便，望尽快解决	BR
跟新，旧版也无法用，删除后也无法，造成非常不便，望尽快解决	BR
无法跟新，旧版也无法用删除后也安装造成非常不便，尽快解决	BR
无法跟新，连旧版本也无法用，删除后也无法安装，造成非常不便，望尽快化解	BR
多年前因为接触云，彻底放弃QQ，而且是再也回不去了。而且对网易云是越来越爱，FM真的很准确，听fm就完全停不下来。尼玛给我推荐30首我就下载了28首	GF
接触网易云，彻底放弃QQ，而且是回不去了。而且对网易越来越爱，私人FM真的是很准确，一旦私人fm，完全停不下来。尼玛给我30首我就下载了28首	GF
多年前因为接触新浪和云音乐，彻底放弃了QQ，而且是再也回不去了。而且对新浪云是越来越爱，私人FM真的是很精准，一旦听私人fm，就完全停不下来。扎西给我推荐30首我就浏览了28首	GF
垃圾，闪退还不支持指纹，越来越高	BR
垃圾，闪退还不支持指纹，越来越	BR
垃圾，闪退还不支持指纹，愈发差	BR
垃圾闪退还不支持指纹，越来越差	BR
污水，闪退还不支持指纹，越来越差	BR
垃圾，闪不支持指纹越来越	BR
垃圾，闪退回不支持指纹，越来越差	BR
废物，闪退还不支持指纹，越来越差	BR
建议微信系统可以投入使用录像聊天有美颜的功能，别的软件都有，除了微信没有	ADV
建议微信系统可以开通聊天美颜的功能，别的软件都有微信没有	ADV
建议微信系统可以开通视频聊天美颜的功能，别的软件都有，除了微信没有	ADV
建议微信可以开通视频聊天的，别的软件都有，微信没有	ADV
建议微信系统可以投入使用视频聊天有美颜的功能，别的软件产品都有，除了微信没有	ADV
建议微信系统可以开通视频聊天有的，别的软件都，除了微信没有	ADV
建议微信系统可以开通录像聊天有美颜的机能，别的软件都有，除了微信没有	ADV
微信为什么还是不可以电脑和ipad同时登陆	ASK
买衣服，买鞋，买生活用品，打车，吃饭，转账。在生活中无处不在的提供方便	GF
是否应该添加一个写日志提醒的闹钟或者通知提醒	ADV
入群验证能否加个验证提示，像QQ群入群验证一样，有个加群的条件提示	ADV
一个财务管理软件竟然占用了我一百多兆，身为小内存用户不得不吐槽一下了	BF
更新后的微信太日龙了，微信更新后，腾讯视频会员微信账号登录不了了，很多授权的app会员都登录不上了，老子表示百分之一百不满意	BR
腾讯视频现在真是飘了，都卸载就不这样了，都VIP了，看个电影，电视剧还得额外花钱。都没人用就好了	BF
垃圾，广告那么多就想让冲会员，偏不充	BF
Y10感谢腾讯视频，陪伴我的每一天，希望你们永远优秀下去	GF
文字信息发不出去，图片秒发的节奏	BR
H6美剧全，画质清晰，方便好用	GF
一直崩一直无法播放歌单一直闪退	BR
如题，没有清除缓存的选项看着还是有些不舒服哒，希望工程师大大加入进去	ADV
很喜欢，每一次更新都在进步，一如既往的支持	GF
很好，很不错的播放器，个人感觉比PPS等强很多，我们提的建议也能及时改进，但是有一点我不明白，为啥手机QQ就做得如此失败呢	ASK
用着挺不错，就是会员有点小贵	ADV
朋友圈明明设置的三天可见，可别人偏偏看不见三天可见这几个字，直接变成一条横线，就跟屏蔽了别人一样。什么垃圾bug啊，所有人都来问，烦死了	BR
只要无安全隐患，会一直用下去	GF
最初以为是类似豆瓣电台的个人网络电台类应用，用了几天才发现可以代替很多在线音乐类软件了，曲库十分丰富，分享功能也很好，整个感觉都不错，很惊喜	GF
推送消息会粘在通知面板上，删也删不掉，以往的消息总是留在面板上天天能看见好烦，只能重启手机。天天重启，以为升级新版本微信就好了，然而还是一个德行，强迫症看着真郁闷	BR
免费的还很好用。功能很多	GF
很好用，也方便，只是自从同事手机丢了，用我手机登录一次他的钉钉账号后，我发给他的消息打给他的短信都转我手机上了，怎样可以彻底注销他的登录啊	ASK
不是最好的听歌软件，却是最走心的听歌软件	GF
用过这个之后再也不想用别的了，推荐的音乐相当对胃口	GF
手表应用无法打卡，差评	BF
完全更新不了卸载也重装不了你都我玩儿啦	BR
真的很不错，很多好听的音乐	GF
知道账号密码登录却显示在新设备上登录要验证短信，我的卡早扔了导致以前的号登录不上去，里面的东西对我很重要，打客服也没用，我知道账号密码都不足以证明我是该账号的主人嘛？醉了，卸载了。有账号有密码却登录不了，服气	BR
别给我们更新点么用的东西，浪费流量，要更新就更新点有用的，我们是手机用户	BF
卡卡卡卡死了。投屏也特么投不上。爱奇艺除非网不好的时候会卡，但是腾讯真的是无缘无故卡	BR
最喜欢的音乐软件干净温馨	GF
更新之前指纹支付好用，更新至8。5后指纹支付失效，再也无法录入指纹	BR
车载蓝牙连接上之后，每句歌词和专辑图一起跳动，手机也是换一句歌词屏幕亮一下，希望修复此bug	BR
交接事项用手机？就你屏幕大是吗？为什么电脑版不能填	BF
为什么下载完的微信没有到手机桌面上	ASK
腾讯给我们带来很多精彩的生活美满。我也很喜欢腾讯的服务。我祝你们以后越来越更好，越来越发展	GF
6s3d_touch快捷功能里面其他功能正常，只有乘车码这一项有问题，具体是选择之后只显示支付宝主页面，不会跳转到乘车码那里	BR
图标都变了，打开页面也很奇怪。就像缩小了页面	BR
特地没更新，取消了app_store的自动更新，结果早上起来防不胜防啊。给我自动更新了说是，真的贼丑，搞得跟新版微博或者新版QQ一样，老年人既视感，颜色也丑	BF
微信特别好玩，里面有小程序等	GF
微信watch应用希望能够支持乘车码	ADV
口区，恶心，从此再也不见，垃圾网易，毁我青春，公平公正只是靠嘴说？刷票不清了解一下？装死	BF
退我会员费，早点下架吧，不舍得花钱买版权就不要玩了，好好养猪就是了	BF
很好用，减少了许多麻烦	GF
日韩动漫只有2部，不是吧	BF
已经很不错了，希望能增加更多无损音乐，另外安卓版希望可以增加类似于ios的高清大屏版本	ADV
不知道怎么回事，我刚买的手机怎么下载不了支付宝和58同城的APP	BR
把资产余额，明细放在三级菜单？请尊重每一位支付宝用户对自己资产及明细账单的查看习惯和重视。不要想用如此拙劣的手法淡化数字金钱观念	ADV
叼你老母，出个这么白痴的软件	BF
就是有时候已经离线好的剧会卡顿	BR
闲的没事开发这种远程监视的鬼app	BF
无语了，更新不了，一直显示此时无法安装，搞得微信打也打不开，想着删了重新下一个，结果连下都下不了了，不晓得是我机子的问题还是什么的	BR
垃圾，更新之后用4g根本用不了	BF
很早就听说了，但最近换工作了才开始使用钉钉，整体觉得还挺好的	GF
初步上手感觉不错，比上一个版本好不少	GF
新版，我的，界面改的乱七八糟的，什么都找不到，不像以前那么一目了然，相比之下还是喜欢之前版本	BF
以前的网易云音乐UI页面都很完美，要什么直接点，现在都是为了会员，页面都大改，没有以前的精致，不喜欢	BF
新版本的聊天文件呢？聊天文件呢？原来发送过的图片、视频、文件等点开聊天文件一目了然，现在居然没有了。找很久以前发的文件手都要翻断了	BR
体验完后满心期待，希望能越来越好	GF
新版本的录音的样式没有之前的好，改成这样有什么意义呢。吃饱没事做的脑残人想这些没实用的	BF
这是我听过最好的音乐播放器	GF
Iphone6s，后台关闭后，打开软件才有消息通知，那么多程序员难道是猪吗	BR
希望日报功能可以放到更容易找的位置	ADV
建议加一个建立群聊的时候需要人同意的功能，莫名其妙的被拉进一个群很恶心的，有些都是一般朋友被拉进一个群还不好意思推出，真的很不爽	ADV
搞不懂国内很多大公司的App总是手机的放大版，丑到死，很多时候还显示不全，专门为iPad适配一个App很难吗	BF
第一次给苹果的软件评价，实在是忍无可忍了。更新了新版本，但是集分宝不能还信用卡了，操作上完全不如上一版本，能不能赶紧完善阿。或者出个更新不好用，能后退版本的插件阿。疯了。支付宝彻底瘫痪	BF
为什么ios系统不能改微信提示音了，求解决啊	ASK
希望微信可以增加一个，批量删除好友的功能，一家公司工作，整个公司的人或是其他方面的人员都要加上好友了，等离开这家公司这个好友要一个个删除真的很麻烦。我每个月谁都要抽筋，删的想吐	ADV
什么破软件，侵犯隐私，功能也不好用，差评	BF
越更新越不好用了，iOS都找不到停用漂流瓶的功能了	BF
你以为你是生活必需品么？说涨价就涨价，还涨那么多，已经不便宜了还涨价，还是用优酷吧，优酷是良心产品，企鹅就是各种抄袭各种心黑，阿里在公益事业没停止过，你却从未开始过	BF
我练车的教练拉我进百人群结果我没有银行卡所以不能绑定，很麻烦，有些通知收不到，风险很大，希望改进	BF
一进来就是可能认识的人的推荐，关不掉，恶心	BF
钉钉不仅满足日常社交，更重要使办公轻松便捷，灰常棒	GF
如同标题，每当我连上wifi看视频但是却网络不稳定切换到自己网络的时候，我不在乎一点流量就点击了流量播放，可你却为什么要我再看一遍广告？90秒的，特别是在月底的时候，我敢说我没那没多流量挥霍了，看个视频信号不稳定，我就得反复看广告，wifi，4G，wifi=90秒广告，每次这样我就会关掉视频，直到什么时候我淡忘这件事，然后又花费我生命中的90秒进入视频，如果运气好我还能直接再进入一段广告，我可去你的吧	BF
转账小伙伴给赚了钱，消息看过了还有提示，再看还有提示，总是有个小红点在那怎么也去不掉	BR
最近发现微信，在输入文字时，聊天记录全白，信息点击发送后消失，强制退出后可以恢复，希望改进	BR
同样的版本，我的微信就没有新表情，是手机版本问题呢	BR
非常好用的软件，很便利，赞赞赞	GF
我挺喜欢这个视频软件的，但是你们真的太败好感了啊啊啊啊，本来都忘记鹅支持他这个事情的你这一提我就想卸载了。干啥啥不行败坏好感第一名，你们太牛了，对了，肖战侮辱女性的事情都有图有真相粉丝还承认了的，你们还搁这洗嘛呢，你自己不是女的吗	BF
不要更新我们习惯了，功能性可以增强，但是版面就不要动了好不好	ADV
叮叮没有提意见的地方吗？我想说在审批报销的记录页面就很渣，无法快捷查找出每笔费用多少，怎么就不能把明细显示出来。啊	ADV
你推出这功能去玩限制时间。你这不逼自己玩很多人去用非官方客户端吗	BF
会员登录，点击微信，没反应，iPhone7p，速度速度解决	BR
发朋友圈，视频，不能长，辣鸡狗玩意转账提现还要身份证	BF
钉钉越来越成熟，及时更新已经成为习惯，办公电话语音导航功能厉害了，希望越来越好，身边人都在用，也会推荐给更多的工作伙伴	GF
挺好用的，但是GG说好的国际长途呢	ASK
我为什么更新不了支付宝，而且之前的版本我现在也用不了	BR
一切都很满意，除了信用卡的自动还款功能还不是非常完善，尤其是农行的	BF
看见鬼啊，看下载下来的视频都要配74分钟的广告，还每一集都是，有完没完	BF
其他都非常好，就是版权问题啊	BF
强烈要求钉兄自拍打卡时给个滤镜	ADV
垃圾软件，广告时间长，还天天弹窗口	BF
很不喜欢各种提醒弹屏，比如别人运动邀请我也开通之类的提醒，各种与我不相干的提醒，超讨厌。还没处屏蔽，我只想接受跟我工作有关的提醒都不行。索性把整个软件的通知都关了	BF
天天恰钱。要充VIP，还要付费观看。一天推几十个消息。片头，片中，片尾，暂停都TM的是广告。电视剧，动漫，老要付费，去搞什么超前观看	BF
新版什么鬼，口令红包都领不了了	BR
为了wp，买个6plus来刷分，就是这么任性。看不起wp，歧视用户。物极必反	BF
试用了一下，够简捷商务，唯一缺点当然是用户数量。不过我同事上面已经有六个人在用	BF
垃圾太垃圾不是分组里的人都不见了，就是动不动就聊天记录没了，太垃圾了，好想爆粗口，太垃圾了	BR
某个导入没了有点可惜	BF
希望朋友圈的相册有一键删除朋友圈和好友或者多选删除功能	ADV
搞那么多功能，安全性忽视了，真恶心，搞得跟微信、美团结合体一样，恶心恶心恶心，第一次写评论差评	BF
朋友推荐就下了个看看，挺好用的，注册了个团队，发现考勤，办公软件类的应用都很方便，功能很强大，还有电话会议，赞	GF
用网易云一年多，从安卓到iOS，跟QQ微信一样存在于每个手机里。真的很喜欢，期待开发更好玩的功能	GF
希望能更新更多的偶像剧或者古装剧，反正就是男女主角颜值高的那类	ADV
这么多播放软件，最喜欢的还是网易云，好用，喜欢	GF
提个邮政卡的现结果上午提现下午还没到账。还收手续费我也是醉了	BF
页面挺好的，内容也丰富	GF
新版本，带耳机听歌，把均衡器打开，声音太小	BR
想给朋友发视频没有了，之前保存的临时视频也没了，现在录完也没有临时保存视频。位置也不好用了	BF
我想知道现在微信哪里可以下，妈的一天没上微信了，还有好多事，气死人了	ASK
个人信息居然群里所有人都能看到	BF
界面调整后看起来更舒适	GF
请腾讯视频正视剧粉诉求】拒绝点播、提前结局】现剧热度讨论度播放量持续增长，拒绝半路截断】播出日程早有安排，拒绝不顾剧粉意愿强行改动】剧粉作为消费者有权表达自己想法理念，请鹅正视剧粉诉求】拒绝点播、提前结局，及时止损，不要作死	ADV
我是长期稳定的会员，因为我喜欢这个播放器，更新的快，也稳定。值得推荐	GF
如果皮肤能换会更好，其他还是不错的	ADV
这是我用过最好好用的应用软件了更新快而且不是很占地方。32个赞，新歌上线，好多都能免费听	GF
为什么有新版本后要强制更新啊。不然就不能登录	ASK
有时老是播放失败，希望改进一下	BR
非常不错，其他的听歌app都不用了，只用网易。其实不止音乐，门户网站看新闻我只看网易，有态度的网易。没有被河蟹，希望坚持住	GF
方便快捷，还是挺好用的	GF
手贱更新后就安装不上了。敢不敢开发好了再推出，吼死我了	BF
下了网易云之后直接把其他的音乐软件删了。只希望可以把华晨宇的版权买下来	GF
不开通会员都是新片，开通会员都是老片，烂片。欺骗消费者	BF
还没有以前好用。现在的弄的总资产看不清楚，而且明明支出了收入了还不更新。总之太难用了	BR
个人信息什么都看不到。点到个人就卡死	BR
希望加入抖一抖功能，提醒人员及时看消息。ding功能不好用	ADV
提高工作效率是钉钉能为我们做的一件事	GF
这个视频很好用，也不卡	GF
腾讯VIP3、想看几部电影全跳转去爱奇艺，还让开通爱奇艺VIP才可以看。我有截图，腾讯客服还不给解释。再说2012年的“我们的快乐人生”腾讯都看不了。无力吐槽了，不信的问597667574要截图，给你们看腾讯客服给我的回复都什么	BR
钉钉有效的改变了企业目前传统低效的沟通现状，加速了企业的信息化，让我们和更多企业都进入到了云和互联的办公方式中了。尤其是钉钉的沟通方面，真正从基础上颠覆了以前低效的沟通模式。也期待功能上可以越来越优化，越来越完美。站在用户的角度，更加优化现在的功能	ADV
内容有些看得了，却缓存不了，如24式简化太极拳带口令的视屏	BF
电台上传的节目要是可以修改名字就更好了	ADV
很好用，希望杰伦版权能再回来，那些评论都很精彩	ADV
完全盗用用户隐私信息，还不断发送骚扰短信，甚至请水军刷app评级，应该下架	BF
除了电话功能取消了，其他越来越好用	BF
为什么我的支付宝没有蚂蚁借呗呢	ASK
很好，让银行躺着赚钱的时代结束了。给社会带来更多服务服务。给中国经济带来活力	GF
升级版对传输文件的支持尤为方便，必须点赞了	GF
我希望微信能直接转发别个的图片和文字，不需要保存图片之后在发朋友圈	ADV
清晰的不错，就是片源太少	ADV
花呗账单变得好难用，以前一目了然的比较方便	BF
很好用有些很喜欢的歌里面也有	GF
之前的版本保存图片很快，现在保存朋友圈图片，超级慢	BF
2年来最主要的交流工具，很方便	GF
用了二年多大软件，真的相对国内软件就是独一无二的存在	GF
谢谢钉钉全面的呵护我们员工，支持我们有序的工作	GF
比其他音乐app好用多了啊，资源也多	GF
现在的读书软件都收钱，这个免费小说挺好用得	GF
怎么说，网易云是个神奇的东西，它让我花了钱，还花了时间写评论，我还很乐意	GF
苹果六怎么下不了腾讯视频	BR
如果可以再给我一次修改微信号的机会，我一定好好珍惜。一次就够了	ADV
不要做这样浪费时间的更新了	ADV
我们自己的软件，越来越棒	GF
什么不负好时光？搞了个选秀节目然后逼选手退赛难道不是负了人家的好时光吗？既然是内定还需要粉丝打投干啥？最好给整个没有点星都能过的评论	BF
看了几年腾讯，好剧不断，继续支持	GF
注册时怎么收不到验证码	BR
爱死但是求花花的更对版权啊，山海	ADV
很不错希望能在后面对报表做进一步提升。比如文本类可以设置下字数，本来只需要填写很少内容，可很大的空格不好看。报表分析能再全面点更好	ADV
强制性人脸识别。建议增加禁用人脸识别选项	ADV
自己收藏的表情不够。才150个。每次忍痛删掉其他的	BF
微信附近的人，怎么一直不能用，垃圾	ASK
这么好的功能给去除了。越更新越垃圾	BF
看朋友圈的视频退出来时卡顿	BR
片源不是很多，但是画面很清晰	GF
看个几分钟的破视频，植入好几段广告，想钱想疯了？mlgb	BF
超级好，就是有一些歌没有	ADV
先说一句靠你全家，连他妈汪峰的歌也收费了，还有，既然收费，能不能把收费的歌曲和不收费的分开，那样你爹不用搜索了，下载一个收费下载一个收费的，靠你妈，我听不起，你们分开可以么	BF
功能越做越杂，隐私越来越不值钱，支付宝作死	BF
推荐的各种好听，给你各种赞	GF
一直很喜欢要是有更多的版权就好了	ADV
很不错，希望多开放些免费的视频。中国电信的天翼视讯是竞争对手喽	ADV
启动速度能不能快点，每次超市付款都要在那里等支付宝启动啊，原来很方便用的功能现在还要进去找，改版完全没抓到关键点啊，这些基本的东西先做好你再去研究什么社交不社交的好不好	ADV
挺好的，就是偶尔闪退。这几年腾讯视频比之前强太多了，无论从界面上、还是内容上。希望腾讯继续努力	BR
升级之后不能在用QQ号码申请微信，家人朋友和客户都在朋友圈，每次发条微信还得想想有没有不适合那组看的内容，太烦了。希望可以有两个账号，不要都是用手机号来申请	ADV
更新完之后没有提示音了。搞什么飞机	BR
小时候老师让大家写想象作文，天马行空的想法在当今得到了验证，可以打电话的手表，出门不用带钞票就可以买东西，薄如板的电视机，帮妈妈减轻负担的洗碗机，全自动洗衣机	GF
涉及钱的东西能不能麻烦你们的系统和功能做的好一些。花呗已经还款，银行卡账单都出来了，可是花呗依然提示未还款，那我的钱哪儿去了？你们连个能联系的人也没有	BR
第一次使用了，方便快捷，很不错的选择，希望更多人使用了	GF
网易云音乐用了好几年了，早早的充了会员，因为版权原因歌曲不全也就算了，这听歌识曲功能也太弱了吧，一首经典的英文歌从开头到结尾都不能识别出来，显示了两首风格完全不一样的歌曲。明年不会再充值会员啦	BF
火死了，手机宝令都找不着了，让我怎么付款啊	ASK
D2上一版本还支持的，升级后不支持了	BR
一周了怎么还没搞定什么破技术	BF
最近有钉钉红包，然后强制分享，强制邀请别人登陆注册。而且在软件内部给差评还数据出错，我就呵呵了	BF
凭什么iOS没有勿扰模式，完全没有隐私	BF
垃圾软件，没有手势密码做屏障，完全不能隐藏余额宝金额，谁都能点开看的到，好想骂人，根本就掩耳盗铃，有个鬼用	BF
我用airplay就是为了能在电视上两倍速看片，结果你给我自动识别视频跟普通投屏似的，什么叫airplay，就是我手机什么样电视就给我什么样，腾讯花大力气改这东西真是吃力不讨好，非常愚蠢。愚蠢至极	BR
如果不开会员能下载mv就好了	ADV
无数个夜晚的悲伤，开心是愉悦的旋律，还有陪伴我运动时的“燃”读书的安静，所有的时间的陪伴，不离不弃	GF
怎么会有这么好用的播放器，如果手机里只有一个软件，一定会是网易云音乐	GF
作为一款手机办公软件，非常方便实用	GF
更新后不能像以往一样一点自动清除缓存，只能选择性清理聊天记录，的确让我一时难以接受。浏览评论，原来大多用户都提出了这个问题。聊天记录有些有时仍需保留，但缓存的却不可不清。缓存一天不清可以，但积久不清就是个问题了。微信一直很好用，此次给少一星是因为出现了这个可大可小的问题。希望能早日恢复自动清缓功能，给我们一个能够自行清理“积压”的空间	ADV
我希望微信能有“信息预约或定时发送”功能，这样我可以在有空的编写好一条信息，并设定好定时发送时间，特别在开车时，我觉得这个功能非常实用，会得到许多人的认可	ADV
钉钉的办公改变了我们公司传统的方式，手机上随时可以处理很多事情，专注模式很赞，能够让我分类管理我的沟通情况	GF
既然天天喊着让给评分，今天就评一次，对不起1星，虽然往后又续了两年会员，但是，你们这个多倍速真的垃圾，我很挑剔，如果多倍速没有声音，实在是难以让我给你好评，火速更新吧，希望把技术做成熟再拿出来炫耀	BF
缓存下来的视频看不了，要联网	BR
这么多年，第一个打差评的，一个签到，迟了就几分钟就扣钱，说自己公司制度不行，也是个事。但是，你发明签到就给了公司，扣钱理由，不是每个人都能正常一天不迟到的，迟到就扣钱。我们挣点钱容易吗。你们自己想想，天天签到	BF
个人感觉优于优酷和爱奇艺	GF
习惯了用网易云音乐，觉得用着很舒服	GF
BAT的APP是在一起比丑吗	BF
很心碎啊，很多软件自动更新了，这个微信怎么调都不能升级	BF
真垃圾，看个视频开始广告130秒，到中间了又是广告90秒，什么时候腾讯视频变成这样了，这是变着法的让开会员啊，真垃圾，还不如爱奇艺呢，广告才45秒	BF
很喜欢这个软件，朋友介绍的	GF
好多歌只有翻唱版没有原唱不能忍啊	BF
一直用腾讯视频，新片跟进很快	GF
支付宝注册的帐号是以前的手机号码，更新了支付宝后登陆要发验证码到以前的手机号码上，现在支付宝登陆不了了	BR
不能免费通话不想用了，越做越差	BF
此更新，非常实用了，不但快递能及时跟踪，连每一笔付款和收款都能看的清清楚楚，不错，绝对5颗星，支付宝付款就是比其他方式快速灵活，但是有一个不实用就是手机充值优惠幅度没有淘宝软件实惠	GF
很多微博上喜欢的po主推荐的歌都不容易找，现在网易云音乐很方便啊	GF
如果不是田馥甄的版权回来了我怕是仍然用着虾米	GF
好像是有人恶意打低分呢，网易云这么好用，竟然被人恶意打低分，不能忍，里面的评论很好哦，用了很久啦	GF
有了支付宝生活真方便。真的很好	GF
节目都是好节目，但是这个广告有点过分吧？切个网络还需要再放一遍么？切清晰度也需要再看一遍么	BF
就是功能太多，都不知道是干啥的	BF
定位从来不准，有问题找客服服务态度极差	BF
垃圾你妈卖。自动扣费老子从来都不知道还叫老子开一个会员出两次钱	BF
希望能把夜间模式置顶群的底色调一调，与非置顶会话差异过大，有点突兀，可以再往深地调一调色	ADV
M6不过会出现追的剧没了，看不了啊。希望赶daw快修复，赞个	ADV
我更新了最新版本后运行内存增加，起码800，mb/1个G的占用内存，真垃圾	BF
我只想说一句:你们的软件很好，但是可不可以把“不能分享超过5分钟的视频”改成10分钟	ADV
比以前好太多了，很喜欢现在这个样子的，很人性化	GF
工作软件，功能强大。就是特别耗电，希望升级的时候能加上省电模式，工作群调成震动，半天也给震没了。不提示又收不到工作信息。不能及时回复，会对工作有影响。在室外最怕没电，不是每个人都是坐办公室不动的，希望可以开通省电模式	BF
每个月自动续费难关就算了，也不是什么大钱，问题就是说好了离线视频等上了飞机后我怎么去打开网络？这样的离线视频有什么意思	BF
是哪个屎一样的程序猿提议“迁移聊天记录到另外一台手机”这个屎一样的建议？还不能关闭屏幕，还必须前台运行，最厌恶的是实际等待的时间非常久，迁移的聊天记录大小远远超出显示的大小。我不是程序猿，我不懂那些技术上的事，但我是用户，我知道这个体验就是踩到屎一样的感觉	BF
我这种把网易云放dock栏的真是一点儿都不想更新，等下个版本改回来在更新	BF
好评，提升效率，管理更方便	GF
花呗还款日最好能自定义一下，不然9号还款，然而十几号才发工资，还款日正好是钱花光光的时候，每次还款很尴尬	ADV
无法使用流量听歌，只能用Wi-Fi。打开流量开关，马上就自动关闭了。蜂窝数据的权限也是开了的	BR
独有的音乐互交平台，设计风格也很棒	GF
突然的所有歌曲都有很大的底噪，根本没法听，想重装的话歌曲就都删除了，给网易写邮件反应也没回，什么态度	BR
你们腾讯真的坑，会员了，好要V会员，要不不能看？你们是吸血鬼么，卸载了	BF
暗黑模式怎么切换回正常模式？不能单独切换吗？必须要跟系统吗？暗黑模式下朋友圈图片黑色，打不开	ASK
转账和支付都很方便。安全设置很到位。还有一点它什么银行卡都支持绑定	GF
更新之后，汇率那一板块变了太多，太商业化了，我想看年/月/周汇率走势，都看不到了，程序员能把它弄回来吗	BF
强烈建议增加屏蔽群对话功能	ADV
要不是为了看你独家垄断的NBA，我干嘛会用，然后你现在app一启动就闪退，闪退了N次。我只能试试重新删包安装。麻烦能不能解决这种严重的问题	BR
更新后，群里文件打不开，一直显示正在加载文件，希望开发者尽快更新，解决问题	BR
Ui，变化了，和新系统很搭配，而且看起来比原来舒服多了	GF
让我看到音乐不单单是用来听的，还是可以用来欣赏的	GF
与A1893版9。7寸iPad不适用，只能显示大概三分之一个屏幕，周围留有大范围的黑屏部分，显示部分大致相仿与6寸手机屏幕大小，望看到此评论后尽快改进	BR
新版本很赞，清新、简单、实用	GF
可以多次改微信号就好。可以多次改微信号就好。可以多次改微信号就好	ADV
微信表情发不出去，下载不了，卸载下载微信以后还是不行，弄的连以前的表情都没有了，发也发不出去，下载也下不了，没意思，哎。这些漏洞还是好好修复吧	BR
我感觉不错，就是一次只能下一个视频，能再多点就好了	ADV
谁要你们的赏金？你们有什么资格赏别人？真拿自己当棵葱了？看见这个字就恶心，对用户连最起码的尊重都没有，还谈什么用户体验	BF
希望会员价格便宜，广告时间短	GF
科技是用来时时刻刻监视你的隐私吗？打卡固定手机还要拍照，劳改犯也不过如此，希望在人道方面能多些进步，这种压榨到底想要换来些什么？还有，强制使用任何app的要求都是垃圾	ADV
请问这么多年了为什么一直不设置夜间模式	ASK
在更换头像之后群头像还是不会变，除非改一下群名字才会刷新，希望可以尽快修复	BR
现在支付宝打不开了是几个意思	BR
很方便，和微信的功能差不多，实用性很好	GF
我只想告诉大家，你们想要的网易云都可以给你们。这里面的每个人都有他们自己的故事，而在看他们的故事的同时仿佛能看到自己的影子。我已经离不开网易云了，因为它既能让我看到她又能让我想要忘掉她。我还是很喜欢你	GF
不错的软件，正在试用，下一步全面推广	GF
钉钉里面可以使用电话会议，也可以考勤，是款非常不错办公软件	GF
一个很不错的工作交流app	GF
好用方便跨时代的通讯软件	GF
Ding的功能很受用，免费电话也很受用。100个赞	GF
新手机出了这么久了还不适配	BF
为什么跟我的Ipad不兼容。下载不了，哪里出了问题	ASK
我就问你暗黑模式你出还是不出，甭整那些没用的，所谓的不想耽误大家晚上睡觉的时间。赶紧出暗黑模式	ADV
突然在点开微信的时候，出现了白板，里面所有的近期联系人都出现了丢失，这个bug	BR
新版的气泡颜色比较柔和，看上去不再刺眼了。喜欢新做的，已读功能，不用展开列表去看想，的人是否已读了。猥琐发育，不要浪，再接再厉	GF
现在要么播不了，要么要会员，要钱听，对于我们这种不追新歌，不为追星的人来说心好累，幸好还有网易音乐，开心，好多歌曲都能听	GF
天天启动就是让我评论，我也是够了	BF
此软件从视觉效果上看比较精细，用起来也比较方便，不错	GF
不单单是个企业IM，在集团信息化应用整合方面真的有很多惊喜	GF
网易云，不只是听歌，一个大家能分享故事的APP，很棒	GF
你不是让给意见嘛，庆余年是怎么回事，会员也冲了，50也花了，你不是更新日多看6集嘛？我6集呢？你这也忒不厚道了，MB拿别人都当傻子呗	BF
新版色调变沉了，不好看啊	BF
除非脑抽了，以后千万不要用苹果支付，首先我对腾讯视频没有什么意见，纯属是对苹果支付账单有意见，每次都是我支付开通会员有问题，每次都是不到账打客服电话，我都醉了	BF
有了微信之后吧，有时候和亲人聊天挺方便。也省点话费了。但是同时也给那些不要脸的人与方便了。需要整改。严加防范	GF
尊敬的广大群友们，相信大家都是支付宝的用户，因为这是一个改变大家生活及行为习惯的软件，但不幸的是支付宝的决策人员却把这种拥护当成了随意驱使，试问强制更新和强奸有何差异？醒醒吧，强奸犯们	BF
本来就充了会员，还要逼粉丝再去充超级会员，想割韭菜也不要吃相这么难看吧	BF
视频大小屏缩小不了，醉了	BF
可能是之前版本用习惯了，从更新后新版本界面采用了大蓝，这是和微信的大绿形成呼应吗？没必要吧，人家小绿最起码是护眼色，这个界面和视觉主色系简直是不想说什么。还用了大行间距、大字号，这是要多大	BF
网易云你就是个垃圾，什么歌都不能听，什么歌都没版权，你干脆倒闭吧	BF
现在版本把NBA板块合并到体育里，很不给力啊，看比赛也不方便，强烈建议恢复NBA板块	ADV
非常棒的一款视频客户端	GF
时间来个500起步就好啦。我习惯了有事没事丁丁一下了	ADV
很好，但是页面更简单点的就好了	ADV
很烂的软件，工作了的事情竟然没有记录。没有记忆功能	BF
撒鼻软件，一直闪退，定位不准	BR
这次的版面真不方便，还没有以前的好，直观简单一点比较好，最新版本的人简直弱智	BF
能更新出一个月可见。别三天。一个月是最好的	ADV
确实不错，看了不少小说，都是免费的，中途也没有什么广告之类的，挺不错的	GF
用过最棒的支付软件，马总的产品	GF
用挺久，挺好，我喜欢这种黑胶唱片的播放画面	GF
多请一个人开发一下wp客户端不行吗，这么大公司对客户这么不尊重真是醉了	ADV
其实它是很不错的，可是还可以再更新其他功能，让它更加方便快捷	ADV
用户体验很差，界面加载很慢，我别的软件都是很快就打开能用了，就这个APP超级慢，打开半天还在转圈圈，连页面都加载不全	BR
网易云音乐真的很棒，但是我有一个小小的意见，那个每日歌单他虽然有很多个但是只会出来6个，点进去的话，找自己喜欢的歌单，要找很久很久，非常的麻烦	ADV
电话会议功能，文件管理功能，阅读打卡，对办公来说好的不得了，给个人发红包再也不用担心其他人抢了	GF
为了看陈情令专门购买了会员，结果剧播到一半突然提出什么点播制。请正视观众合理诉求:我们拒绝，提前大结局，拒绝超级会员点播，更拒绝不被重视只被当作韭菜割	BF
没有vip广告时间太长，不好	BF
自从公司用了这个软件，整个人生就不分工作与休息了。慎用啊。能不能开发个功能，下班后继续使用影响员工休息的，一次罚款10万	BF
日常陪伴，用上就不离开	GF
给普通百姓的福利，好好好	GF
网易的真的很不错，很用心	GF
很好用，有活动，有同学已经成功，推荐	GF
这个应用帮我的管理更加高效及时	GF
刚还清钱，就不能用了，好尴尬	BF
用了很久了才评论的，很不错	GF
如果群聊的时候能加个禁言功能就好了	ADV
人在国外，用微信微博都不能登录账户，必须提交手机号，手机号又只能提交86的，这是在搞笑吗？而且不知道为什么一定要提交手机号，听歌而已，要花钱不会自己付钱吗，微信本来都是实名的，和手机号码有啥关系	BR
把其他方式付款关闭了，想用手机银行付款都不行了，不开通信用卡付款的商户，只能用信用卡付款的买家就要付手续费，这就是变相收钱，希望手机客户端能越来越便捷，不要这样处处收费，让很多好买家失去很多客户	BF
我是老用户了，天天使用支付宝转账付款收款等往来账户，非常实用，五星好评	GF
很多QQ音乐要付费的歌，在这都能下载	GF
T5强制更新以后就各种播放不了了	BR
我就想问问为什么这几天我还蚂蚁借呗（主动还款）一直交易失败？还有转账系统也是交易失败？充值系统也是交易失败	ASK
小视频，就应该像原来一样小而方便，现在变成全屏一点也不方便还不能撤回，表情也莫名变超级大所以还更模糊	BF
朋友推荐用的，简洁大方，音质也不错。还有复古碟片让人眼前一亮	GF
这个版本不能支持一键转发内容到朋友圈	BF
我昨天开通腾讯视频会员，微信支付成功了，为什么腾讯会员到现在没给我开通	BR
一直以来都是用腾讯会员的，早之前就有报道过说会员超前点播的问题，要不要吃相难看啊，充会员为的就是不用看一分多钟的广告，享受会员能提前看的权利，充会员后还有会员广告，想要提前看下集还要继续交费才能看，身为会员我想问这个会员还有什么用吗？会员本身有的权利享受不到	BF
我们什么时候，电台节目上唱歌呢用苹果的	ASK
系统无法连接无线网，登陆不了，蜂窝状态下可用，不知道为什么	BR
帐号总是闪退。朋友买的会员不用了，我登录上，自己就闪退了。就我一个人用没有别人	BR
除了很多歌没有版权外，反正我也是几个播放器轮著用的	ADV
一直用着网易云，希望越做越好	GF
钉钉打卡法定节假日不打卡也算旷工，设计者是外国人吧，或脑子进水	BF
今天一大早更新了，进入支付宝直接闪退。早知道不更新了	BR
推荐歌曲功能是用过的软件中最好的	GF
方便，快捷，高效，绿色，低碳	GF
删了重新装也不可以，能不能解决一下	BR
无法跳过设置头像的步骤，太过霸道，强迫客户，已删除，希望下个版本改进	ADV
I8为啥搜索功能用不了？dd？而且更新之后电影板块去哪里了	ASK
估计也就制造业的小公司，才会将狭小心胸寄托在这种软件上，局限使用考勤功能吧	BF
听音乐只用云村，这还用说吗？哈哈，只可惜网易爸爸不宠我，我玩的游戏也都是网易的qvq非的要命，不过好是真的好啦	GF
辣鸡软件，其他APP投屏看电影都没问题，就腾讯视频无法投屏。浪费我的钱充会员	BF
不能用，点击更新后完全不能用，搞得现在我都不能用腾讯看电视了，亏得我还支持了这么久，骗子	BR
不用注册可以下高清音乐	GF
越更新越不好用昵称字符不能修改了	BF
进度条也不好按，无法正常快进快退啊。还有音画经常不同步是要闹哪样	BR
这次更新最垃圾，如果可以下会之前的版本就好了	BF
非常好用的app，果断删除同类软件	GF
垃圾，更新版本后点哪里都闪退，可惜我的会员了，垃圾，真的搞不懂这种烂版本居然能发出来	BR
资源比较多，会员画质清晰，挺喜欢的	GF
陈情令和庆余年都很好看，会一直支持腾讯视频和肖战。品牌方更清楚肖战是什么人，风波过去后他还是那个最耀眼的男孩	GF
我的视频"页历史记录写成了"纪录"错别字哦	BR
阿里巴巴出品，信息安全有保障，我们公司已经全部在用钉钉了	GF
钉钉对于工作者而言，极大程度的节省了劳动力，我们家远的，也可以通过钉钉会议的形式，进行开会，随时随地都可以开会，都可以交流，这也促进了同事间的友谊	GF
希望有些歌能争取到版权，花钱也没关系的，嘻嘻	ADV
还不错，挺好用的，方便的很	GF
作为一个四川人，我想说的是，支付宝。巴适	GF
特别喜欢，听歌还可以看评论，互动感十足	GF
越升级越垃圾，转账麻烦死，微信都做起来了，用了你这么久从来没这么差过。脑残设计师	BF
以前那个版本挺好的昂，更新要考虑用户习惯，别成为第二个腾讯，大小操作不方便	ADV
工作方便多了，审批流程也更快	GF
苹果ig6，下不了，的怎么办	ASK
个人，公司，企业，集团，用这个软件非常适合，强烈推荐	GF
用支付宝手机支付的时候，总是跳转到另一款软件上，不知道为什么	BR
什么都好，就是tm的我的借呗怎么就是不能用	BF
上下班自动打卡，再也不用担心忘打卡了，审批报销，越来越方便，最好的办公软件没有之一	GF
督促每天的运动量，不久坐，挺好的	GF
微信后台运行收不到就算了，打开微信收到消息，就收不到接下来的消息必须重新打开才能收到，为什么	BR
wx什么都挺好的，就是发朋友圈视频权限不太好，可以不设置权限，我觉得如果可以发长视频真的就完美了	ADV
每天上下班都省去了指模打卡。全用手机。很方便	GF
不是标题和内容对不上，就是胡乱剪辑的视频，腾讯视频内容半点观赏价值没有	BF
通用审批通过后如何按审批内容关键字进行搜索	ASK
最近蚂蚁宝卡针对钉钉免流量了，所以安装来聊天，感觉很不错呢	GF
失望，看着看着网就断了。别的App都能连上，就腾讯视频连不上，有毒啊。还我看个电视剧都看不过瘾	BR
视频比较多，比爱奇艺免费的片子多	GF
办公交流利器，非常好用;但个人隐私在企业里变的随意，对以后个人隐私情况堪忧	BF
什么支付宝。绑定了什么都改不了，被别人盗用了都不知道。钱被盗了也不知道找谁赔。垃圾	BF
最新系统有问题，无法登陆，只能手机号登陆，无法选择其他方式	BR
下一版本希望适配暗黑模式	ADV
很好用的软件，界面很喜欢，唯一的不足就是版权太少，很多歌听不了	ADV
不能屏蔽微信群，这么简单的功能也做不到吗？不能屏蔽微信群，这么简单的功能也做不到吗？不能屏蔽微信群，这么简单的功能也做不到吗	ASK
到了支付页面就毛线的选择银行卡，明明绑定叻银行卡了啊，为毛没有选项，现在根本无法用支付宝付款了昂	BR
希望下次更新能有后台或者浮窗播放语音条的功能	ADV
好用，就是转账金额太少，只有20万，如果可以到100就好了	BF
软件软件更新不了，删了重新下载还下载不起了，说什么软件更新起了冲突，真的想爆粗口了	BF
很好用，如果直接可以连淘宝就更好了	ADV
十分感谢，找了很久了，期待高品质无损版	ADV
我唯一买的会员，很好用	GF
办公软件，你值得拥有，做得很好	GF
很多之前听过偏门的音乐都能找到，很开心，也能推荐很好听的冷门音乐	GF
我强迫症，对一些细节比较注重，总体对钉钉，是非常的喜欢	GF
可以听到很多欧美音乐。很难找的音乐都可以在网易云音乐找到。非常棒	GF
非常好的一款app，支持	GF
必须后台关掉重开app才能出声音	BR
自从用了网易云以来，就再也没用过其他的音乐软件。网易云简直如同我心里的蛔虫希望，每天的每日推荐总是让我心头一颤。我的音乐品味也因为网易云从最开始的流行到古风到民谣再到最后的电音。真的自从用了网易云我的腿都不会正经放了，一刻不抖就感觉不正常了	GF
随时随地办公，非常好的和同事协作办公	GF
功能不要太多，界面太臃肿	ADV
网页只能试看5分钟，App登陆闪退，还我一年会费	BR
希望推出长截图功能	ADV
支付密码忘记了。按提示从新设置了，可就是不正确	BR
推荐的歌单都很智能而且个人化。亮点在于评论，有时候听着歌看评论都能看好几个小时。在这里，你能看到他人一样在路上，一种有差异的共鸣，鼓励你安慰你	GF
闪退啊我的各位技术大哥们。好累心。一遍遍闪。不是恶意评论。我爱网易音乐啊。我也很绝望	BR
很好的软件，很实用。我想，离不开它了	GF
我目前买东西，车票用花呗，转账到账快，不收手续费，零钱存入余额宝还能挣钱，真心越用越爽快，赞一百个的	GF
真的很垃圾，打不上卡有时候。系统繁忙。客服界面打不开别的都可以	BF
一直在用，很方便。芝麻信用还可以与更多的领域联系，给大家带来方便。加油马云哥	GF
1:是回拨电话。2:没有拨号键盘。3:淘宝购物习惯性5星	BF
真心是从未用过比腾讯视频更垃圾的视频播放软件了，不说会员不会员，下载的视频还要卡顿，恶心到极致	BF
非常好的娱乐。集影视游戏于一体，直播笑话乐大家。一款非常好的app，我喜欢	GF
非常方便，转账不需要手续费	GF
要是取消了手势密码功能，那一点隐私都没有了。账户里多少钱别人随时都知道。要是真的取消了，支付宝里一分钱都不敢放了	BF
一颗星的不满足是微信号不能更改。当年我年少无知设置的微信号呀	BF
这是一捆很好的社交软件，赞	GF
我都用它听电子乐，感觉比其他软件强多了。什么是歌曲，什么是音乐，层次不一样	GF
通用功能已很强大，轻OA	GF
用了挺久了，感觉推荐的也很符合自己的胃口，总体感觉很棒	GF
微信密码通过申诉后，然后要修改密码，修改不了。为什么。公众号没有一个回复的。有什么用	BR
苹果6刷朋友圈卡顿掉帧，望优化	BR
无法跟新，连旧版也无法用，删除后也无法安装，造成非常不便，望尽快解决	BR
多年前因为接触网易云音乐，彻底放弃了QQ，而且是再也回不去了。而且对网易云是越来越爱，私人FM真的是很准确，一旦听私人fm，就完全停不下来。尼玛给我推荐30首我就下载了28首	GF
垃圾，闪退还不支持指纹，越来越差	BR
建议微信系统可以开通视频聊天有美颜的功能，别的软件都有，除了微信没有	ADV
